ags,name,bundesland_id,bundesland,bevoelkerung_total,bevoelkerung_maennlich,bevoelkerung_weiblich,mj_wohnort_insgesamt,mj_wohnort_ausschliesslich,mj_wohnort_nebenjob,mj_arbeitsort_insgesamt,mj_arbeitsort_ausschliesslich,mj_arbeitsort_nebenjob,mj_wohnort_insgesamt_prozent,mj_wohnort_ausschliesslich_prozent,mj_wohnort_nebenjob_prozent,mj_arbeitsort_insgesamt_prozent,mj_arbeitsort_ausschliesslich_prozent,mj_arbeitsort_nebenjob_prozent
08111000,"Stuttgart, Landeshauptstadt",08,Baden-Württemberg,623738,310492,313246,57430,33844,23586,68576,40497,28079,9.2,5.4,3.8,11.0,6.5,4.5
08115003,"Böblingen, Stadt",08,Baden-Württemberg,48696,23935,24761,4978,2688,2290,5998,3235,2763,10.2,5.5,4.7,12.3,6.6,5.7
08115028,"Leonberg, Stadt",08,Baden-Württemberg,47219,23432,23787,4127,2350,1777,5006,2644,2362,8.7,5.0,3.8,10.6,5.6,5.0
08115029,Magstadt,08,Baden-Württemberg,9323,4782,4541,1007,554,453,610,360,250,10.8,5.9,4.9,6.5,3.9,2.7
08115041,"Renningen, Stadt",08,Baden-Württemberg,17107,8550,8557,1589,961,628,1297,793,504,9.3,5.6,3.7,7.6,4.6,2.9
08115042,"Rutesheim, Stadt",08,Baden-Württemberg,10624,5280,5344,1004,607,397,762,470,292,9.5,5.7,3.7,7.2,4.4,2.7
08115044,Schönaich,08,Baden-Württemberg,10083,5069,5014,1028,584,444,992,534,458,10.2,5.8,4.4,9.8,5.3,4.5
08115045,"Sindelfingen, Stadt",08,Baden-Württemberg,63971,31678,32293,6338,3473,2865,6728,3763,2965,9.9,5.4,4.5,10.5,5.9,4.6
08115050,"Weil der Stadt, Stadt",08,Baden-Württemberg,18652,9273,9379,1802,1051,751,3028,2208,820,9.7,5.6,4.0,16.2,11.8,4.4
08115051,Weil im Schönbuch,08,Baden-Württemberg,9816,4835,4981,1032,611,421,648,389,259,10.5,6.2,4.3,6.6,4.0,2.6
08115052,Weissach,08,Baden-Württemberg,7490,3707,3783,724,432,292,449,249,200,9.7,5.8,3.9,6.0,3.3,2.7
08115001,Aidlingen,08,Baden-Württemberg,8843,4346,4497,826,507,319,511,312,199,9.3,5.7,3.6,5.8,3.5,2.3
08115054,Grafenau,08,Baden-Württemberg,6735,3417,3318,570,348,222,326,203,123,8.5,5.2,3.3,4.8,3.0,1.8
08115013,Ehningen,08,Baden-Württemberg,8694,4298,4396,820,478,342,976,549,427,9.4,5.5,3.9,11.2,6.3,4.9
08115015,Gärtringen,08,Baden-Württemberg,11882,5849,6033,1134,680,454,1039,577,462,9.5,5.7,3.8,8.7,4.9,3.9
08115010,Deckenpfronn,08,Baden-Württemberg,3306,1646,1660,324,200,124,340,210,130,9.8,6.0,3.8,10.3,6.4,3.9
08115021,"Herrenberg, Stadt",08,Baden-Württemberg,31003,15193,15810,3116,1851,1265,3088,1813,1275,10.1,6.0,4.1,10.0,5.8,4.1
08115037,Nufringen,08,Baden-Württemberg,5503,2770,2733,502,288,214,523,255,268,9.1,5.2,3.9,9.5,4.6,4.9
08115002,Altdorf,08,Baden-Württemberg,4651,2321,2330,419,248,171,279,153,126,9.0,5.3,3.7,6.0,3.3,2.7
08115022,Hildrizhausen,08,Baden-Württemberg,3645,1874,1771,432,251,181,198,121,77,11.9,6.9,5.0,5.4,3.3,2.1
08115024,"Holzgerlingen, Stadt",08,Baden-Württemberg,12635,6229,6406,1331,790,541,2633,1976,657,10.5,6.3,4.3,20.8,15.6,5.2
08115004,Bondorf,08,Baden-Württemberg,5854,2939,2915,609,372,237,514,334,180,10.4,6.4,4.0,8.8,5.7,3.1
08115016,Gäufelden,08,Baden-Württemberg,9231,4635,4596,1006,619,387,639,369,270,10.9,6.7,4.2,6.9,4.0,2.9
08115034,Mötzingen,08,Baden-Württemberg,3608,1767,1841,432,253,179,283,162,121,12.0,7.0,5.0,7.8,4.5,3.4
08115053,Jettingen,08,Baden-Württemberg,7654,3794,3860,838,500,338,494,287,207,10.9,6.5,4.4,6.5,3.7,2.7
08115046,Steinenbronn,08,Baden-Württemberg,6466,3307,3159,740,396,344,500,252,248,11.4,6.1,5.3,7.7,3.9,3.8
08115048,"Waldenbuch, Stadt",08,Baden-Württemberg,8590,4237,4353,913,547,366,1962,1109,853,10.6,6.4,4.3,22.8,12.9,9.9
08116015,Denkendorf,08,Baden-Württemberg,10707,5401,5306,1187,684,503,1015,592,423,11.1,6.4,4.7,9.5,5.5,4.0
08116019,"Esslingen am Neckar, Stadt",08,Baden-Württemberg,91271,45219,46052,8654,5063,3591,9968,5681,4287,9.5,5.5,3.9,10.9,6.2,4.7
08116047,Neuhausen auf den Fildern,08,Baden-Württemberg,11741,5860,5881,1264,681,583,1101,619,482,10.8,5.8,5.0,9.4,5.3,4.1
08116072,"Wernau (Neckar), Stadt",08,Baden-Württemberg,12376,6185,6191,1205,679,526,854,486,368,9.7,5.5,4.3,6.9,3.9,3.0
08116076,Aichwald,08,Baden-Württemberg,7470,3625,3845,667,408,259,481,294,187,8.9,5.5,3.5,6.4,3.9,2.5
08116077,"Filderstadt, Stadt",08,Baden-Württemberg,44977,22273,22704,5516,3071,2445,5103,2798,2305,12.3,6.8,5.4,11.3,6.2,5.1
08116078,"Leinfelden-Echterdingen, Stadt",08,Baden-Württemberg,39071,19288,19783,4070,2334,1736,5070,2757,2313,10.4,6.0,4.4,13.0,7.1,5.9
08116080,"Ostfildern, Stadt",08,Baden-Württemberg,38519,19006,19513,3862,2257,1605,5707,4026,1681,10.0,5.9,4.2,14.8,10.5,4.4
08116081,"Aichtal, Stadt",08,Baden-Württemberg,10124,5200,4924,1014,602,412,662,371,291,10.0,5.9,4.1,6.5,3.7,2.9
08116016,Dettingen unter Teck,08,Baden-Württemberg,6010,3045,2965,634,391,243,752,452,300,10.5,6.5,4.0,12.5,7.5,5.0
08116033,"Kirchheim unter Teck, Stadt",08,Baden-Württemberg,40094,19773,20321,4469,2648,1821,4783,2945,1838,11.1,6.6,4.5,11.9,7.3,4.6
08116048,Notzingen,08,Baden-Württemberg,3631,1863,1768,335,222,113,227,135,92,9.2,6.1,3.1,6.3,3.7,2.5
08116018,Erkenbrechtsweiler,08,Baden-Württemberg,2143,1072,1071,288,149,139,212,101,111,13.4,7.0,6.5,9.9,4.7,5.2
08116054,"Owen, Stadt",08,Baden-Württemberg,3415,1729,1686,382,234,148,330,190,140,11.2,6.9,4.3,9.7,5.6,4.1
08116079,Lenningen,08,Baden-Württemberg,8026,4050,3976,958,543,415,691,346,345,11.9,6.8,5.2,8.6,4.3,4.3
08116005,Altdorf,08,Baden-Württemberg,1620,811,809,178,96,82,97,65,32,11.0,5.9,5.1,6.0,4.0,2.0
08116006,Altenriet,08,Baden-Württemberg,1904,939,965,187,118,69,83,42,41,9.8,6.2,3.6,4.4,2.2,2.2
08116008,Bempflingen,08,Baden-Württemberg,3474,1755,1719,380,232,148,472,308,164,10.9,6.7,4.3,13.6,8.9,4.7
08116041,Neckartailfingen,08,Baden-Württemberg,3716,1864,1852,410,251,159,321,186,135,11.0,6.8,4.3,8.6,5.0,3.6
08116042,Neckartenzlingen,08,Baden-Württemberg,6542,3300,3242,762,443,319,608,380,228,11.6,6.8,4.9,9.3,5.8,3.5
08116063,Schlaitdorf,08,Baden-Württemberg,1886,921,965,194,117,77,55,38,17,10.3,6.2,4.1,2.9,2.0,0.9
08116011,Beuren,08,Baden-Württemberg,3549,1754,1795,386,233,153,272,158,114,10.9,6.6,4.3,7.7,4.5,3.2
08116036,Kohlberg,08,Baden-Württemberg,2268,1117,1151,220,131,89,364,222,142,9.7,5.8,3.9,16.0,9.8,6.3
08116046,"Neuffen, Stadt",08,Baden-Württemberg,6210,3138,3072,686,388,298,458,240,218,11.0,6.2,4.8,7.4,3.9,3.5
08116020,Frickenhausen,08,Baden-Württemberg,8844,4388,4456,1084,640,444,896,534,362,12.3,7.2,5.0,10.1,6.0,4.1
08116022,Großbettlingen,08,Baden-Württemberg,4290,2098,2192,440,250,190,378,195,183,10.3,5.8,4.4,8.8,4.5,4.3
08116049,"Nürtingen, Stadt",08,Baden-Württemberg,40535,20262,20273,4416,2609,1807,4320,2507,1813,10.9,6.4,4.5,10.7,6.2,4.5
08116050,Oberboihingen,08,Baden-Württemberg,5469,2688,2781,559,318,241,366,209,157,10.2,5.8,4.4,6.7,3.8,2.9
08116068,Unterensingen,08,Baden-Württemberg,4782,2389,2393,459,256,203,317,176,141,9.6,5.4,4.2,6.6,3.7,2.9
08116073,Wolfschlugen,08,Baden-Württemberg,6340,3094,3246,645,373,272,456,266,190,10.2,5.9,4.3,7.2,4.2,3.0
08116004,Altbach,08,Baden-Württemberg,6043,3062,2981,605,316,289,361,174,187,10.0,5.2,4.8,6.0,2.9,3.1
08116014,Deizisau,08,Baden-Württemberg,6735,3473,3262,680,382,298,667,395,272,10.1,5.7,4.4,9.9,5.9,4.0
08116056,"Plochingen, Stadt",08,Baden-Württemberg,13997,6869,7128,1439,868,571,1618,938,680,10.3,6.2,4.1,11.6,6.7,4.9
08116007,Baltmannsweiler,08,Baden-Württemberg,5646,2759,2887,545,306,239,262,166,96,9.7,5.4,4.2,4.6,2.9,1.7
08116027,Hochdorf,08,Baden-Württemberg,4895,2521,2374,422,264,158,340,178,162,8.6,5.4,3.2,6.9,3.6,3.3
08116037,Lichtenwald,08,Baden-Württemberg,2567,1266,1301,225,135,90,95,57,38,8.8,5.3,3.5,3.7,2.2,1.5
08116058,Reichenbach an der Fils,08,Baden-Württemberg,8236,4097,4139,920,530,390,788,478,310,11.2,6.4,4.7,9.6,5.8,3.8
08116012,Bissingen an der Teck,08,Baden-Württemberg,3481,1794,1687,385,261,124,382,241,141,11.1,7.5,3.6,11.0,6.9,4.1
08116029,Holzmaden,08,Baden-Württemberg,2222,1099,1123,237,134,103,187,113,74,10.7,6.0,4.6,8.4,5.1,3.3
08116043,Neidlingen,08,Baden-Württemberg,1838,924,914,189,130,59,89,62,27,10.3,7.1,3.2,4.8,3.4,1.5
08116053,Ohmden,08,Baden-Württemberg,1719,868,851,181,121,60,74,49,25,10.5,7.0,3.5,4.3,2.9,1.5
08116070,"Weilheim an der Teck, Stadt",08,Baden-Württemberg,10052,5065,4987,1103,601,502,1226,684,542,11.0,6.0,5.0,12.2,6.8,5.4
08116035,Köngen,08,Baden-Württemberg,9718,4793,4925,931,528,403,1113,620,493,9.6,5.4,4.1,11.5,6.4,5.1
08116071,"Wendlingen am Neckar, Stadt",08,Baden-Württemberg,15974,7900,8074,1746,1022,724,1309,729,580,10.9,6.4,4.5,8.2,4.6,3.6
08117010,Böhmenkirch,08,Baden-Württemberg,5512,2887,2625,587,369,218,501,292,209,10.6,6.7,4.0,9.1,5.3,3.8
08117006,Bad Ditzenbach,08,Baden-Württemberg,3652,1823,1829,406,253,153,325,222,103,11.1,6.9,4.2,8.9,6.1,2.8
08117014,Deggingen,08,Baden-Württemberg,5279,2617,2662,515,328,187,380,221,159,9.8,6.2,3.5,7.2,4.2,3.0
08117018,"Ebersbach an der Fils, Stadt",08,Baden-Württemberg,15206,7545,7661,1487,889,598,1056,610,446,9.8,5.8,3.9,6.9,4.0,2.9
08117044,Schlierbach,08,Baden-Württemberg,3927,1964,1963,418,260,158,299,183,116,10.6,6.6,4.0,7.6,4.7,3.0
08117019,"Eislingen/Fils, Stadt",08,Baden-Württemberg,20177,9944,10233,2265,1294,971,1901,1066,835,11.2,6.4,4.8,9.4,5.3,4.1
08117037,Ottenbach,08,Baden-Württemberg,2463,1236,1227,264,162,102,153,94,59,10.7,6.6,4.1,6.2,3.8,2.4
08117042,Salach,08,Baden-Württemberg,7921,3889,4032,881,513,368,772,458,314,11.1,6.5,4.6,9.7,5.8,4.0
08117007,Bad Überkingen,08,Baden-Württemberg,3793,1877,1916,389,239,150,357,222,135,10.3,6.3,4.0,9.4,5.9,3.6
08117024,"Geislingen an der Steige, Stadt",08,Baden-Württemberg,27168,13461,13707,2777,1756,1021,3092,2004,1088,10.2,6.5,3.8,11.4,7.4,4.0
08117033,Kuchen,08,Baden-Württemberg,5520,2782,2738,587,345,242,349,195,154,10.6,6.2,4.4,6.3,3.5,2.8
08117026,"Göppingen, Stadt",08,Baden-Württemberg,56781,28128,28653,5746,3360,2386,6833,4060,2773,10.1,5.9,4.2,12.0,7.2,4.9
08117043,Schlat,08,Baden-Württemberg,1682,826,856,183,118,65,85,54,31,10.9,7.0,3.9,5.1,3.2,1.8
08117053,Wäschenbeuren,08,Baden-Württemberg,3909,1886,2023,360,228,132,164,115,49,9.2,5.8,3.4,4.2,2.9,1.3
08117055,Wangen,08,Baden-Württemberg,3071,1532,1539,300,198,102,253,164,89,9.8,6.4,3.3,8.2,5.3,2.9
08117015,"Donzdorf, Stadt",08,Baden-Württemberg,10769,5366,5403,1137,717,420,856,567,289,10.6,6.7,3.9,7.9,5.3,2.7
08117025,Gingen an der Fils,08,Baden-Württemberg,4329,2143,2186,459,308,151,450,269,181,10.6,7.1,3.5,10.4,6.2,4.2
08117049,"Süßen, Stadt",08,Baden-Württemberg,10050,5089,4961,1018,601,417,745,444,301,10.1,6.0,4.1,7.4,4.4,3.0
08117061,"Lauterstein, Stadt",08,Baden-Württemberg,2561,1259,1302,244,162,82,221,138,83,9.5,6.3,3.2,8.6,5.4,3.2
08117016,Drackenstein,08,Baden-Württemberg,408,200,208,55,32,23,23,11,12,13.5,7.8,5.6,5.6,2.7,2.9
08117028,Gruibingen,08,Baden-Württemberg,2200,1149,1051,240,123,117,150,82,68,10.9,5.6,5.3,6.8,3.7,3.1
08117031,Hohenstadt,08,Baden-Württemberg,817,447,370,107,82,25,40,31,9,13.1,10.0,3.1,4.9,3.8,1.1
08117035,Mühlhausen im Täle,08,Baden-Württemberg,1019,511,508,115,74,41,111,75,36,11.3,7.3,4.0,10.9,7.4,3.5
08117058,"Wiesensteig, Stadt",08,Baden-Württemberg,2056,1060,996,207,121,86,168,116,52,10.1,5.9,4.2,8.2,5.6,2.5
08117001,Adelberg,08,Baden-Württemberg,1956,973,983,180,127,53,140,82,58,9.2,6.5,2.7,7.2,4.2,3.0
08117009,Birenbach,08,Baden-Württemberg,1908,955,953,176,107,69,95,63,32,9.2,5.6,3.6,5.0,3.3,1.7
08117011,Börtlingen,08,Baden-Württemberg,1699,847,852,163,98,65,63,32,31,9.6,5.8,3.8,3.7,1.9,1.8
08117038,Rechberghausen,08,Baden-Württemberg,5424,2646,2778,528,304,224,409,248,161,9.7,5.6,4.1,7.5,4.6,3.0
08117002,Aichelberg,08,Baden-Württemberg,1300,675,625,134,85,49,98,55,43,10.3,6.5,3.8,7.5,4.2,3.3
08117012,Bad Boll,08,Baden-Württemberg,5110,2460,2650,469,261,208,571,337,234,9.2,5.1,4.1,11.2,6.6,4.6
08117017,Dürnau,08,Baden-Württemberg,2066,1023,1043,262,168,94,230,142,88,12.7,8.1,4.5,11.1,6.9,4.3
08117023,Gammelshausen,08,Baden-Württemberg,1429,730,699,147,83,64,53,34,19,10.3,5.8,4.5,3.7,2.4,1.3
08117029,Hattenhofen,08,Baden-Württemberg,2978,1495,1483,307,192,115,188,123,65,10.3,6.4,3.9,6.3,4.1,2.2
08117060,Zell unter Aichelberg,08,Baden-Württemberg,3087,1549,1538,325,182,143,416,244,172,10.5,5.9,4.6,13.5,7.9,5.6
08117003,Albershausen,08,Baden-Württemberg,4196,2097,2099,423,273,150,266,171,95,10.1,6.5,3.6,6.3,4.1,2.3
08117051,"Uhingen, Stadt",08,Baden-Württemberg,14036,6945,7091,1431,858,573,1337,750,587,10.2,6.1,4.1,9.5,5.3,4.2
08117020,Eschenbach,08,Baden-Württemberg,2176,1074,1102,218,130,88,292,189,103,10.0,6.0,4.0,13.4,8.7,4.7
08117030,Heiningen,08,Baden-Württemberg,5114,2516,2598,534,339,195,417,229,188,10.4,6.6,3.8,8.2,4.5,3.7
08118003,"Asperg, Stadt",08,Baden-Württemberg,13315,6615,6700,1305,756,549,1296,747,549,9.8,5.7,4.1,9.7,5.6,4.1
08118011,"Ditzingen, Stadt",08,Baden-Württemberg,24633,12192,12441,2341,1352,989,1961,1117,844,9.5,5.5,4.0,8.0,4.5,3.4
08118019,"Gerlingen, Stadt",08,Baden-Württemberg,19450,9517,9933,1674,1022,652,2141,1233,908,8.6,5.3,3.4,11.0,6.3,4.7
08118021,"Großbottwar, Stadt",08,Baden-Württemberg,8325,4184,4141,790,490,300,660,408,252,9.5,5.9,3.6,7.9,4.9,3.0
08118046,"Kornwestheim, Stadt",08,Baden-Württemberg,33153,16470,16683,3315,1880,1435,2777,1645,1132,10.0,5.7,4.3,8.4,5.0,3.4
08118048,"Ludwigsburg, Stadt",08,Baden-Württemberg,92973,45743,47230,8770,5131,3639,10549,6265,4284,9.4,5.5,3.9,11.3,6.7,4.6
08118050,"Markgröningen, Stadt",08,Baden-Württemberg,14555,7357,7198,1492,815,677,1061,612,449,10.3,5.6,4.7,7.3,4.2,3.1
08118051,Möglingen,08,Baden-Württemberg,11158,5526,5632,1189,667,522,987,510,477,10.7,6.0,4.7,8.8,4.6,4.3
08118060,Oberstenfeld,08,Baden-Württemberg,7928,3929,3999,871,516,355,774,464,310,11.0,6.5,4.5,9.8,5.9,3.9
08118076,"Sachsenheim, Stadt",08,Baden-Württemberg,18170,8986,9184,1887,1106,781,1336,772,564,10.4,6.1,4.3,7.4,4.2,3.1
08118080,"Korntal-Münchingen, Stadt",08,Baden-Württemberg,19143,9611,9532,1794,1051,743,1637,1039,598,9.4,5.5,3.9,8.6,5.4,3.1
08118081,"Remseck am Neckar, Stadt",08,Baden-Württemberg,25759,12733,13026,2337,1353,984,1303,753,550,9.1,5.3,3.8,5.1,2.9,2.1
08118007,"Besigheim, Stadt",08,Baden-Württemberg,12018,5928,6090,1153,691,462,1247,724,523,9.6,5.7,3.8,10.4,6.0,4.4
08118016,Freudental,08,Baden-Württemberg,2440,1205,1235,209,136,73,106,68,38,8.6,5.6,3.0,4.3,2.8,1.6
08118018,Gemmrigheim,08,Baden-Württemberg,4040,2037,2003,405,234,171,192,112,80,10.0,5.8,4.2,4.8,2.8,2.0
08118028,Hessigheim,08,Baden-Württemberg,2384,1193,1191,230,133,97,152,85,67,9.6,5.6,4.1,6.4,3.6,2.8
08118047,Löchgau,08,Baden-Württemberg,5536,2765,2771,579,351,228,390,240,150,10.5,6.3,4.1,7.0,4.3,2.7
08118053,Mundelsheim,08,Baden-Württemberg,3276,1686,1590,338,204,134,252,139,113,10.3,6.2,4.1,7.7,4.2,3.4
08118074,Walheim,08,Baden-Württemberg,3129,1560,1569,309,192,117,132,74,58,9.9,6.1,3.7,4.2,2.4,1.9
08118071,Tamm,08,Baden-Württemberg,12798,6450,6348,1170,647,523,874,500,374,9.1,5.1,4.1,6.8,3.9,2.9
08118077,Ingersheim,08,Baden-Württemberg,6193,3029,3164,600,339,261,346,195,151,9.7,5.5,4.2,5.6,3.1,2.4
08118079,"Bietigheim-Bissingen, Stadt",08,Baden-Württemberg,42968,21115,21853,4136,2336,1800,4775,2699,2076,9.6,5.4,4.2,11.1,6.3,4.8
08118010,"Bönnigheim, Stadt",08,Baden-Württemberg,7593,3753,3840,888,538,350,718,455,263,11.7,7.1,4.6,9.5,6.0,3.5
08118015,Erligheim,08,Baden-Württemberg,2743,1387,1356,262,136,126,269,165,104,9.6,5.0,4.6,9.8,6.0,3.8
08118040,Kirchheim am Neckar,08,Baden-Württemberg,5608,2794,2814,647,387,260,446,285,161,11.5,6.9,4.6,8.0,5.1,2.9
08118063,Pleidelsheim,08,Baden-Württemberg,6284,3102,3182,584,331,253,520,299,221,9.3,5.3,4.0,8.3,4.8,3.5
08118078,"Freiberg am Neckar, Stadt",08,Baden-Württemberg,15741,7698,8043,1545,931,614,1854,1191,663,9.8,5.9,3.9,11.8,7.6,4.2
08118001,Affalterbach,08,Baden-Württemberg,4451,2218,2233,452,268,184,342,201,141,10.2,6.0,4.1,7.7,4.5,3.2
08118006,Benningen am Neckar,08,Baden-Württemberg,6212,3118,3094,584,355,229,327,177,150,9.4,5.7,3.7,5.3,2.8,2.4
08118014,Erdmannhausen,08,Baden-Württemberg,4871,2469,2402,458,269,189,335,197,138,9.4,5.5,3.9,6.9,4.0,2.8
08118049,"Marbach am Neckar, Stadt",08,Baden-Württemberg,15477,7567,7910,1528,872,656,1157,740,417,9.9,5.6,4.2,7.5,4.8,2.7
08118027,Hemmingen,08,Baden-Württemberg,7416,3708,3708,700,399,301,433,276,157,9.4,5.4,4.1,5.8,3.7,2.1
08118067,Schwieberdingen,08,Baden-Württemberg,11323,5689,5634,1023,560,463,901,427,474,9.0,4.9,4.1,8.0,3.8,4.2
08118054,Murr,08,Baden-Württemberg,6413,3143,3270,691,405,286,722,406,316,10.8,6.3,4.5,11.3,6.3,4.9
08118070,"Steinheim an der Murr, Stadt",08,Baden-Württemberg,12219,6073,6146,1125,668,457,769,459,310,9.2,5.5,3.7,6.3,3.8,2.5
08118012,Eberdingen,08,Baden-Württemberg,6701,3380,3321,709,428,281,410,223,187,10.6,6.4,4.2,6.1,3.3,2.8
08118059,"Oberriexingen, Stadt",08,Baden-Württemberg,3297,1676,1621,317,192,125,223,134,89,9.6,5.8,3.8,6.8,4.1,2.7
08118068,Sersheim,08,Baden-Württemberg,5686,2834,2852,584,363,221,313,198,115,10.3,6.4,3.9,5.5,3.5,2.0
08118073,"Vaihingen an der Enz, Stadt",08,Baden-Württemberg,28695,14238,14457,2970,1769,1201,3043,1799,1244,10.4,6.2,4.2,10.6,6.3,4.3
08119001,Alfdorf,08,Baden-Württemberg,7099,3598,3501,779,494,285,616,368,248,11.0,7.0,4.0,8.7,5.2,3.5
08119020,"Fellbach, Stadt",08,Baden-Württemberg,45147,21854,23293,5043,2846,2197,8565,4565,4000,11.2,6.3,4.9,19.0,10.1,8.9
08119041,Korb,08,Baden-Württemberg,10544,5140,5404,1120,668,452,805,466,339,10.6,6.3,4.3,7.6,4.4,3.2
08119044,"Murrhardt, Stadt",08,Baden-Württemberg,13727,6788,6939,1437,882,555,1202,757,445,10.5,6.4,4.0,8.8,5.5,3.2
08119061,Rudersberg,08,Baden-Württemberg,11179,5608,5571,1195,715,480,783,458,325,10.7,6.4,4.3,7.0,4.1,2.9
08119079,"Waiblingen, Stadt",08,Baden-Württemberg,54263,26598,27665,5663,3316,2347,6525,3870,2655,10.4,6.1,4.3,12.0,7.1,4.9
08119089,Berglen,08,Baden-Württemberg,6136,3062,3074,648,402,246,500,292,208,10.6,6.6,4.0,8.1,4.8,3.4
08119090,Remshalden,08,Baden-Württemberg,14076,6979,7097,1367,816,551,987,589,398,9.7,5.8,3.9,7.0,4.2,2.8
08119091,"Weinstadt, Stadt",08,Baden-Württemberg,26685,13147,13538,2610,1583,1027,2413,1415,998,9.8,5.9,3.8,9.0,5.3,3.7
08119093,Kernen im Remstal,08,Baden-Württemberg,15187,7571,7616,1454,874,580,1194,682,512,9.6,5.8,3.8,7.9,4.5,3.4
08119003,Allmersbach im Tal,08,Baden-Württemberg,4739,2376,2363,471,302,169,252,165,87,9.9,6.4,3.6,5.3,3.5,1.8
08119004,Althütte,08,Baden-Württemberg,4092,2043,2049,469,291,178,341,211,130,11.5,7.1,4.3,8.3,5.2,3.2
08119006,Auenwald,08,Baden-Württemberg,6780,3404,3376,686,427,259,397,234,163,10.1,6.3,3.8,5.9,3.5,2.4
08119008,"Backnang, Stadt",08,Baden-Württemberg,36266,18033,18233,3679,2202,1477,4424,2726,1698,10.1,6.1,4.1,12.2,7.5,4.7
08119018,Burgstetten,08,Baden-Württemberg,3635,1824,1811,346,209,137,239,158,81,9.5,5.7,3.8,6.6,4.3,2.2
08119038,Kirchberg an der Murr,08,Baden-Württemberg,3771,1878,1893,375,228,147,434,183,251,9.9,6.0,3.9,11.5,4.9,6.7
08119053,Oppenweiler,08,Baden-Württemberg,4161,2117,2044,421,261,160,281,193,88,10.1,6.3,3.8,6.8,4.6,2.1
08119083,Weissach im Tal,08,Baden-Württemberg,7113,3512,3601,712,462,250,426,270,156,10.0,6.5,3.5,6.0,3.8,2.2
08119087,Aspach,08,Baden-Württemberg,8035,4043,3992,907,551,356,849,520,329,11.3,6.9,4.4,10.6,6.5,4.1
08119055,Plüderhausen,08,Baden-Württemberg,9368,4621,4747,1057,657,400,905,539,366,11.3,7.0,4.3,9.7,5.8,3.9
08119076,Urbach,08,Baden-Württemberg,8817,4378,4439,927,527,400,735,395,340,10.5,6.0,4.5,8.3,4.5,3.9
08119067,"Schorndorf, Stadt",08,Baden-Württemberg,39172,19224,19948,4043,2360,1683,4153,2486,1667,10.3,6.0,4.3,10.6,6.3,4.3
08119086,Winterbach,08,Baden-Württemberg,7579,3689,3890,731,428,303,803,482,321,9.6,5.6,4.0,10.6,6.4,4.2
08119024,Großerlach,08,Baden-Württemberg,2514,1338,1176,227,149,78,173,103,70,9.0,5.9,3.1,6.9,4.1,2.8
08119069,Spiegelberg,08,Baden-Württemberg,2098,1089,1009,213,132,81,111,55,56,10.2,6.3,3.9,5.3,2.6,2.7
08119075,Sulzbach an der Murr,08,Baden-Württemberg,5173,2569,2604,509,310,199,365,209,156,9.8,6.0,3.8,7.1,4.0,3.0
08119037,Kaisersbach,08,Baden-Württemberg,2504,1284,1220,325,197,128,267,168,99,13.0,7.9,5.1,10.7,6.7,4.0
08119084,"Welzheim, Stadt",08,Baden-Württemberg,11063,5386,5677,1295,798,497,1093,700,393,11.7,7.2,4.5,9.9,6.3,3.6
08119042,Leutenbach,08,Baden-Württemberg,11215,5541,5674,1093,664,429,608,376,232,9.7,5.9,3.8,5.4,3.4,2.1
08119068,Schwaikheim,08,Baden-Württemberg,9386,4596,4790,950,537,413,634,383,251,10.1,5.7,4.4,6.8,4.1,2.7
08119085,"Winnenden, Stadt",08,Baden-Württemberg,27932,13855,14077,2698,1531,1167,2351,1408,943,9.7,5.5,4.2,8.4,5.0,3.4
08121000,"Heilbronn, Stadt",08,Baden-Württemberg,122567,61268,61299,13499,7928,5571,18658,11063,7595,11.0,6.5,4.5,15.2,9.0,6.2
08125007,"Bad Wimpfen, Stadt",08,Baden-Württemberg,6971,3461,3510,693,422,271,617,390,227,9.9,6.1,3.9,8.9,5.6,3.3
08125039,"Gundelsheim, Stadt",08,Baden-Württemberg,7258,3620,3638,733,453,280,526,323,203,10.1,6.2,3.9,7.2,4.5,2.8
08125058,Leingarten,08,Baden-Württemberg,11187,5576,5611,1209,710,499,1210,689,521,10.8,6.3,4.5,10.8,6.2,4.7
08125068,"Neudenau, Stadt",08,Baden-Württemberg,5103,2564,2539,469,301,168,310,215,95,9.2,5.9,3.3,6.1,4.2,1.9
08125107,Wüstenrot,08,Baden-Württemberg,6837,3357,3480,695,414,281,455,289,166,10.2,6.1,4.1,6.7,4.2,2.4
08125005,"Bad Friedrichshall, Stadt",08,Baden-Württemberg,19019,9603,9416,2041,1152,889,1439,852,587,10.7,6.1,4.7,7.6,4.5,3.1
08125078,Oedheim,08,Baden-Württemberg,6303,3166,3137,595,336,259,277,178,99,9.4,5.3,4.1,4.4,2.8,1.6
08125079,Offenau,08,Baden-Württemberg,2665,1299,1366,289,172,117,303,206,97,10.8,6.5,4.4,11.4,7.7,3.6
08125006,"Bad Rappenau, Stadt",08,Baden-Württemberg,20510,10065,10445,2066,1226,840,2034,1177,857,10.1,6.0,4.1,9.9,5.7,4.2
08125049,Kirchardt,08,Baden-Württemberg,5649,2899,2750,536,332,204,282,177,105,9.5,5.9,3.6,5.0,3.1,1.9
08125087,Siegelsbach,08,Baden-Württemberg,1671,852,819,178,106,72,163,98,65,10.7,6.3,4.3,9.8,5.9,3.9
08125013,"Brackenheim, Stadt",08,Baden-Württemberg,15727,7904,7823,1746,1039,707,1618,1093,525,11.1,6.6,4.5,10.3,6.9,3.3
08125017,Cleebronn,08,Baden-Württemberg,2858,1469,1389,327,197,130,382,208,174,11.4,6.9,4.5,13.4,7.3,6.1
08125026,"Eppingen, Stadt",08,Baden-Württemberg,21312,10630,10682,2248,1381,867,1982,1213,769,10.5,6.5,4.1,9.3,5.7,3.6
08125034,Gemmingen,08,Baden-Württemberg,5080,2533,2547,564,341,223,343,203,140,11.1,6.7,4.4,6.8,4.0,2.8
08125047,Ittlingen,08,Baden-Württemberg,2472,1252,1220,271,180,91,176,103,73,11.0,7.3,3.7,7.1,4.2,3.0
08125030,Flein,08,Baden-Württemberg,6918,3325,3593,657,372,285,557,312,245,9.5,5.4,4.1,8.1,4.5,3.5
08125094,Talheim,08,Baden-Württemberg,4918,2467,2451,504,298,206,433,241,192,10.2,6.1,4.2,8.8,4.9,3.9
08125056,"Lauffen am Neckar, Stadt",08,Baden-Württemberg,11042,5395,5647,1157,710,447,981,577,404,10.5,6.4,4.0,8.9,5.2,3.7
08125066,Neckarwestheim,08,Baden-Württemberg,3709,1883,1826,423,243,180,299,156,143,11.4,6.6,4.9,8.1,4.2,3.9
08125074,Nordheim,08,Baden-Württemberg,8021,3973,4048,857,516,341,474,268,206,10.7,6.4,4.3,5.9,3.3,2.6
08125048,Jagsthausen,08,Baden-Württemberg,1802,907,895,177,97,80,187,91,96,9.8,5.4,4.4,10.4,5.0,5.3
08125063,"Möckmühl, Stadt",08,Baden-Württemberg,7902,4021,3881,770,481,289,649,403,246,9.7,6.1,3.7,8.2,5.1,3.1
08125084,Roigheim,08,Baden-Württemberg,1420,761,659,120,75,45,68,45,23,8.5,5.3,3.2,4.8,3.2,1.6
08125103,"Widdern, Stadt",08,Baden-Württemberg,1829,937,892,201,116,85,99,70,29,11.0,6.3,4.6,5.4,3.8,1.6
08125027,Erlenbach,08,Baden-Württemberg,4969,2471,2498,551,307,244,470,273,197,11.1,6.2,4.9,9.5,5.5,4.0
08125065,"Neckarsulm, Stadt",08,Baden-Württemberg,26304,13146,13158,2873,1677,1196,2979,1666,1313,10.9,6.4,4.5,11.3,6.3,5.0
08125096,Untereisesheim,08,Baden-Württemberg,4145,2067,2078,441,276,165,409,229,180,10.6,6.7,4.0,9.9,5.5,4.3
08125069,"Neuenstadt am Kocher, Stadt",08,Baden-Württemberg,9630,4823,4807,1025,600,425,969,583,386,10.6,6.2,4.4,10.1,6.1,4.0
08125111,Hardthausen am Kocher,08,Baden-Württemberg,4094,2182,1912,393,223,170,177,107,70,9.6,5.4,4.2,4.3,2.6,1.7
08125113,Langenbrettach,08,Baden-Württemberg,3733,1933,1800,417,247,170,271,149,122,11.2,6.6,4.6,7.3,4.0,3.3
08125038,"Güglingen, Stadt",08,Baden-Württemberg,6168,3155,3013,655,382,273,736,420,316,10.6,6.2,4.4,11.9,6.8,5.1
08125081,Pfaffenhofen,08,Baden-Württemberg,2335,1181,1154,284,183,101,156,105,51,12.2,7.8,4.3,6.7,4.5,2.2
08125108,Zaberfeld,08,Baden-Württemberg,3929,1957,1972,432,260,172,267,154,113,11.0,6.6,4.4,6.8,3.9,2.9
08125059,"Löwenstein, Stadt",08,Baden-Württemberg,3231,1617,1614,368,205,163,533,348,185,11.4,6.3,5.0,16.5,10.8,5.7
08125110,Obersulm,08,Baden-Württemberg,13567,6797,6770,1498,906,592,1676,844,832,11.0,6.7,4.4,12.4,6.2,6.1
08125001,Abstatt,08,Baden-Württemberg,4752,2449,2303,510,318,192,375,226,149,10.7,6.7,4.0,7.9,4.8,3.1
08125008,"Beilstein, Stadt",08,Baden-Württemberg,6178,3075,3103,658,388,270,583,332,251,10.7,6.3,4.4,9.4,5.4,4.1
08125046,Ilsfeld,08,Baden-Württemberg,9233,4685,4548,1026,594,432,1098,616,482,11.1,6.4,4.7,11.9,6.7,5.2
08125098,Untergruppenbach,08,Baden-Württemberg,8276,4118,4158,794,482,312,776,474,302,9.6,5.8,3.8,9.4,5.7,3.6
08125061,Massenbachhausen,08,Baden-Württemberg,3402,1730,1672,406,244,162,402,239,163,11.9,7.2,4.8,11.8,7.0,4.8
08125086,"Schwaigern, Stadt",08,Baden-Württemberg,11173,5632,5541,1273,770,503,1264,733,531,11.4,6.9,4.5,11.3,6.6,4.8
08125021,Eberstadt,08,Baden-Württemberg,3175,1574,1601,340,200,140,185,94,91,10.7,6.3,4.4,5.8,3.0,2.9
08125024,Ellhofen,08,Baden-Württemberg,3562,1784,1778,431,252,179,347,203,144,12.1,7.1,5.0,9.7,5.7,4.0
08125057,Lehrensteinsfeld,08,Baden-Württemberg,2348,1206,1142,219,145,74,119,82,37,9.3,6.2,3.2,5.1,3.5,1.6
08125102,"Weinsberg, Stadt",08,Baden-Württemberg,12001,5987,6014,1252,727,525,927,522,405,10.4,6.1,4.4,7.7,4.3,3.4
08126011,Bretzfeld,08,Baden-Württemberg,12367,6214,6153,1401,799,602,1101,640,461,11.3,6.5,4.9,8.9,5.2,3.7
08126072,Schöntal,08,Baden-Württemberg,5562,2814,2748,571,365,206,512,326,186,10.3,6.6,3.7,9.2,5.9,3.3
08126047,Kupferzell,08,Baden-Württemberg,6074,3118,2956,679,375,304,587,319,268,11.2,6.2,5.0,9.7,5.3,4.4
08126058,"Neuenstein, Stadt",08,Baden-Württemberg,6506,3301,3205,682,388,294,962,521,441,10.5,6.0,4.5,14.8,8.0,6.8
08126085,"Waldenburg, Stadt",08,Baden-Württemberg,3046,1575,1471,366,242,124,428,262,166,12.0,7.9,4.1,14.1,8.6,5.4
08126020,Dörzbach,08,Baden-Württemberg,2463,1225,1238,293,157,136,228,144,84,11.9,6.4,5.5,9.3,5.8,3.4
08126045,"Krautheim, Stadt",08,Baden-Württemberg,4542,2370,2172,492,300,192,439,250,189,10.8,6.6,4.2,9.7,5.5,4.2
08126056,Mulfingen,08,Baden-Württemberg,3700,1942,1758,469,269,200,356,199,157,12.7,7.3,5.4,9.6,5.4,4.2
08126039,"Ingelfingen, Stadt",08,Baden-Württemberg,5516,2714,2802,645,372,273,647,360,287,11.7,6.7,4.9,11.7,6.5,5.2
08126046,"Künzelsau, Stadt",08,Baden-Württemberg,15127,7632,7495,1831,1013,818,1600,990,610,12.1,6.7,5.4,10.6,6.5,4.0
08126028,"Forchtenberg, Stadt",08,Baden-Württemberg,4919,2483,2436,538,315,223,467,265,202,10.9,6.4,4.5,9.5,5.4,4.1
08126060,"Niedernhall, Stadt",08,Baden-Württemberg,4002,2055,1947,427,227,200,269,160,109,10.7,5.7,5.0,6.7,4.0,2.7
08126086,Weißbach,08,Baden-Württemberg,2039,1006,1033,231,122,109,182,91,91,11.3,6.0,5.3,8.9,4.5,4.5
08126066,"Öhringen, Stadt",08,Baden-Württemberg,23489,11683,11806,2616,1452,1164,2476,1402,1074,11.1,6.2,5.0,10.5,6.0,4.6
08126069,Pfedelbach,08,Baden-Württemberg,9156,4573,4583,1025,584,441,782,454,328,11.2,6.4,4.8,8.5,5.0,3.6
08126094,Zweiflingen,08,Baden-Württemberg,1673,864,809,177,109,68,118,76,42,10.6,6.5,4.1,7.1,4.5,2.5
08127008,Blaufelden,08,Baden-Württemberg,5217,2761,2456,593,360,233,918,636,282,11.4,6.9,4.5,17.6,12.2,5.4
08127052,Mainhardt,08,Baden-Württemberg,5880,2941,2939,621,369,252,409,245,164,10.6,6.3,4.3,7.0,4.2,2.8
08127075,"Schrozberg, Stadt",08,Baden-Württemberg,5651,2908,2743,689,437,252,480,318,162,12.2,7.7,4.5,8.5,5.6,2.9
08127009,Braunsbach,08,Baden-Württemberg,2518,1275,1243,291,171,120,169,92,77,11.6,6.8,4.8,6.7,3.7,3.1
08127086,Untermünkheim,08,Baden-Württemberg,2938,1495,1443,320,197,123,279,135,144,10.9,6.7,4.2,9.5,4.6,4.9
08127014,"Crailsheim, Stadt",08,Baden-Württemberg,33768,17020,16748,3538,1998,1540,4066,2383,1683,10.5,5.9,4.6,12.0,7.1,5.0
08127073,Satteldorf,08,Baden-Württemberg,5330,2727,2603,579,339,240,434,261,173,10.9,6.4,4.5,8.1,4.9,3.2
08127103,Frankenhardt,08,Baden-Württemberg,4821,2468,2353,508,320,188,281,162,119,10.5,6.6,3.9,5.8,3.4,2.5
08127104,Stimpfach,08,Baden-Württemberg,3095,1648,1447,304,195,109,194,133,61,9.8,6.3,3.5,6.3,4.3,2.0
08127101,Kreßberg,08,Baden-Württemberg,3889,1985,1904,430,270,160,245,134,111,11.1,6.9,4.1,6.3,3.4,2.9
08127102,Fichtenau,08,Baden-Württemberg,4595,2314,2281,542,380,162,354,249,105,11.8,8.3,3.5,7.7,5.4,2.3
08127032,"Gerabronn, Stadt",08,Baden-Württemberg,4223,2145,2078,540,306,234,509,291,218,12.8,7.2,5.5,12.1,6.9,5.2
08127047,"Langenburg, Stadt",08,Baden-Württemberg,1790,918,872,201,131,70,248,151,97,11.2,7.3,3.9,13.9,8.4,5.4
08127043,"Ilshofen, Stadt",08,Baden-Württemberg,6415,3268,3147,692,387,305,550,296,254,10.8,6.0,4.8,8.6,4.6,4.0
08127089,"Vellberg, Stadt",08,Baden-Württemberg,4302,2153,2149,436,247,189,286,162,124,10.1,5.7,4.4,6.6,3.8,2.9
08127099,Wolpertshausen,08,Baden-Württemberg,2100,1068,1032,235,127,108,444,211,233,11.2,6.0,5.1,21.1,10.0,11.1
08127023,Fichtenberg,08,Baden-Württemberg,2875,1459,1416,311,186,125,274,158,116,10.8,6.5,4.3,9.5,5.5,4.0
08127025,"Gaildorf, Stadt",08,Baden-Württemberg,12072,5956,6116,1323,818,505,1130,720,410,11.0,6.8,4.2,9.4,6.0,3.4
08127062,Oberrot,08,Baden-Württemberg,3562,1773,1789,400,232,168,320,176,144,11.2,6.5,4.7,9.0,4.9,4.0
08127079,Sulzbach-Laufen,08,Baden-Württemberg,2520,1275,1245,282,166,116,266,143,123,11.2,6.6,4.6,10.6,5.7,4.9
08127012,Bühlertann,08,Baden-Württemberg,2995,1497,1498,312,195,117,191,124,67,10.4,6.5,3.9,6.4,4.1,2.2
08127013,Bühlerzell,08,Baden-Württemberg,2016,1020,996,204,129,75,155,101,54,10.1,6.4,3.7,7.7,5.0,2.7
08127063,Obersontheim,08,Baden-Württemberg,4769,2434,2335,519,303,216,337,195,142,10.9,6.4,4.5,7.1,4.1,3.0
08127046,"Kirchberg an der Jagst, Stadt",08,Baden-Württemberg,4293,2281,2012,402,251,151,357,194,163,9.4,5.8,3.5,8.3,4.5,3.8
08127071,Rot am See,08,Baden-Württemberg,5305,2687,2618,614,404,210,558,350,208,11.6,7.6,4.0,10.5,6.6,3.9
08127091,Wallhausen,08,Baden-Württemberg,3618,1839,1779,439,244,195,1022,629,393,12.1,6.7,5.4,28.2,17.4,10.9
08127056,Michelbach an der Bilz,08,Baden-Württemberg,3406,1695,1711,340,205,135,172,95,77,10.0,6.0,4.0,5.0,2.8,2.3
08127059,Michelfeld,08,Baden-Württemberg,3717,1908,1809,428,246,182,487,264,223,11.5,6.6,4.9,13.1,7.1,6.0
08127076,"Schwäbisch Hall, Stadt",08,Baden-Württemberg,38827,18763,20064,4153,2344,1809,5533,3234,2299,10.7,6.0,4.7,14.3,8.3,5.9
08127100,Rosengarten,08,Baden-Württemberg,5107,2506,2601,546,335,211,274,165,109,10.7,6.6,4.1,5.4,3.2,2.1
08128020,"Creglingen, Stadt",08,Baden-Württemberg,4731,2412,2319,526,339,187,468,310,158,11.1,7.2,4.0,9.9,6.6,3.3
08128039,"Freudenberg, Stadt",08,Baden-Württemberg,3800,1902,1898,442,288,154,357,252,105,11.6,7.6,4.1,9.4,6.6,2.8
08128064,"Külsheim, Stadt",08,Baden-Württemberg,5187,2691,2496,608,408,200,368,243,125,11.7,7.9,3.9,7.1,4.7,2.4
08128082,"Niederstetten, Stadt",08,Baden-Württemberg,4822,2435,2387,602,386,216,476,302,174,12.5,8.0,4.5,9.9,6.3,3.6
08128126,"Weikersheim, Stadt",08,Baden-Württemberg,7324,3645,3679,801,488,313,688,419,269,10.9,6.7,4.3,9.4,5.7,3.7
08128131,"Wertheim, Stadt",08,Baden-Württemberg,23405,11692,11713,2672,1612,1060,2661,1674,987,11.4,6.9,4.5,11.4,7.2,4.2
08128139,"Lauda-Königshofen, Stadt",08,Baden-Württemberg,14573,7218,7355,1620,1037,583,1366,895,471,11.1,7.1,4.0,9.4,6.1,3.2
08128006,Assamstadt,08,Baden-Württemberg,2246,1122,1124,271,157,114,200,119,81,12.1,7.0,5.1,8.9,5.3,3.6
08128007,"Bad Mergentheim, Stadt",08,Baden-Württemberg,23064,11151,11913,2430,1452,978,2772,1758,1014,10.5,6.3,4.2,12.0,7.6,4.4
08128058,Igersheim,08,Baden-Württemberg,5543,2758,2785,591,386,205,383,242,141,10.7,7.0,3.7,6.9,4.4,2.5
08128014,"Boxberg, Stadt",08,Baden-Württemberg,6630,3364,3266,800,512,288,596,389,207,12.1,7.7,4.3,9.0,5.9,3.1
08128138,Ahorn,08,Baden-Württemberg,2186,1128,1058,218,151,67,187,110,77,10.0,6.9,3.1,8.6,5.0,3.5
08128047,"Grünsfeld, Stadt",08,Baden-Württemberg,3603,1831,1772,410,271,139,359,219,140,11.4,7.5,3.9,10.0,6.1,3.9
08128137,Wittighausen,08,Baden-Württemberg,1647,836,811,193,118,75,130,75,55,11.7,7.2,4.6,7.9,4.6,3.3
08128045,Großrinderfeld,08,Baden-Württemberg,3920,1977,1943,400,283,117,246,179,67,10.2,7.2,3.0,6.3,4.6,1.7
08128061,Königheim,08,Baden-Württemberg,3035,1531,1504,289,202,87,163,105,58,9.5,6.7,2.9,5.4,3.5,1.9
08128115,"Tauberbischofsheim, Stadt",08,Baden-Württemberg,13201,6569,6632,1343,797,546,2181,1395,786,10.2,6.0,4.1,16.5,10.6,6.0
08128128,Werbach,08,Baden-Württemberg,3264,1629,1635,356,252,104,181,129,52,10.9,7.7,3.2,5.5,4.0,1.6
08135010,Dischingen,08,Baden-Württemberg,4352,2239,2113,467,299,168,570,377,193,10.7,6.9,3.9,13.1,8.7,4.4
08135015,Gerstetten,08,Baden-Württemberg,11664,5787,5877,1183,706,477,901,557,344,10.1,6.1,4.1,7.7,4.8,2.9
08135020,"Herbrechtingen, Stadt",08,Baden-Württemberg,12915,6341,6574,1269,742,527,1013,591,422,9.8,5.7,4.1,7.8,4.6,3.3
08135025,Königsbronn,08,Baden-Württemberg,7142,3532,3610,606,375,231,327,195,132,8.5,5.3,3.2,4.6,2.7,1.8
08135032,Steinheim am Albuch,08,Baden-Württemberg,8638,4290,4348,823,511,312,1271,715,556,9.5,5.9,3.6,14.7,8.3,6.4
08135016,"Giengen an der Brenz, Stadt",08,Baden-Württemberg,19342,9654,9688,1817,1088,729,1205,780,425,9.4,5.6,3.8,6.2,4.0,2.2
08135021,Hermaringen,08,Baden-Württemberg,2162,1111,1051,167,111,56,69,44,25,7.7,5.1,2.6,3.2,2.0,1.2
08135019,"Heidenheim an der Brenz, Stadt",08,Baden-Württemberg,48048,23752,24296,4736,2906,1830,5644,3352,2292,9.9,6.0,3.8,11.7,7.0,4.8
08135026,Nattheim,08,Baden-Württemberg,6241,3163,3078,634,366,268,587,346,241,10.2,5.9,4.3,9.4,5.5,3.9
08135027,"Niederstotzingen, Stadt",08,Baden-Württemberg,4611,2311,2300,527,294,233,452,277,175,11.4,6.4,5.1,9.8,6.0,3.8
08135031,Sontheim an der Brenz,08,Baden-Württemberg,5412,2716,2696,567,328,239,497,311,186,10.5,6.1,4.4,9.2,5.7,3.4
08136002,Abtsgmünd,08,Baden-Württemberg,7293,3653,3640,826,496,330,753,474,279,11.3,6.8,4.5,10.3,6.5,3.8
08136027,Gschwend,08,Baden-Württemberg,4966,2473,2493,557,337,220,402,250,152,11.2,6.8,4.4,8.1,5.0,3.1
08136042,"Lorch, Stadt",08,Baden-Württemberg,10800,5440,5360,1155,694,461,1416,768,648,10.7,6.4,4.3,13.1,7.1,6.0
08136045,"Neresheim, Stadt",08,Baden-Württemberg,7935,4082,3853,840,521,319,707,425,282,10.6,6.6,4.0,8.9,5.4,3.6
08136050,"Oberkochen, Stadt",08,Baden-Württemberg,7761,3826,3935,747,445,302,501,314,187,9.6,5.7,3.9,6.5,4.0,2.4
08136021,Essingen,08,Baden-Württemberg,6407,3187,3220,671,416,255,813,506,307,10.5,6.5,4.0,12.7,7.9,4.8
08136033,Hüttlingen,08,Baden-Württemberg,6030,2979,3051,655,430,225,465,315,150,10.9,7.1,3.7,7.7,5.2,2.5
08136088,"Aalen, Stadt",08,Baden-Württemberg,67344,33312,34032,7028,4408,2620,8847,5535,3312,10.4,6.5,3.9,13.1,8.2,4.9
08136010,"Bopfingen, Stadt",08,Baden-Württemberg,11822,5845,5977,1259,836,423,1007,684,323,10.6,7.1,3.6,8.5,5.8,2.7
08136037,Kirchheim am Ries,08,Baden-Württemberg,1896,972,924,257,172,85,179,127,52,13.6,9.1,4.5,9.4,6.7,2.7
08136087,Riesbürg,08,Baden-Württemberg,2309,1152,1157,285,179,106,122,83,39,12.3,7.8,4.6,5.3,3.6,1.7
08136003,Adelmannsfelden,08,Baden-Württemberg,1714,862,852,227,158,69,97,62,35,13.2,9.2,4.0,5.7,3.6,2.0
08136018,Ellenberg,08,Baden-Württemberg,1692,847,845,194,114,80,164,106,58,11.5,6.7,4.7,9.7,6.3,3.4
08136019,"Ellwangen (Jagst), Stadt",08,Baden-Württemberg,26574,13698,12876,2635,1652,983,3040,1840,1200,9.9,6.2,3.7,11.4,6.9,4.5
08136035,Jagstzell,08,Baden-Württemberg,2318,1175,1143,265,180,85,159,107,52,11.4,7.8,3.7,6.9,4.6,2.2
08136046,Neuler,08,Baden-Württemberg,3166,1585,1581,398,242,156,275,164,111,12.6,7.6,4.9,8.7,5.2,3.5
08136060,Rosenberg,08,Baden-Württemberg,2633,1363,1270,291,180,111,193,105,88,11.1,6.8,4.2,7.3,4.0,3.3
08136084,Wört,08,Baden-Württemberg,1369,707,662,153,97,56,135,93,42,11.2,7.1,4.1,9.9,6.8,3.1
08136089,Rainau,08,Baden-Württemberg,3256,1674,1582,375,235,140,224,138,86,11.5,7.2,4.3,6.9,4.2,2.6
08136038,"Lauchheim, Stadt",08,Baden-Württemberg,4727,2396,2331,512,308,204,371,221,150,10.8,6.5,4.3,7.8,4.7,3.2
08136082,Westhausen,08,Baden-Württemberg,6007,3038,2969,692,413,279,740,412,328,11.5,6.9,4.6,12.3,6.9,5.5
08136020,Eschach,08,Baden-Württemberg,1752,865,887,191,104,87,146,88,58,10.9,5.9,5.0,8.3,5.0,3.3
08136024,Göggingen,08,Baden-Württemberg,2460,1218,1242,238,142,96,149,90,59,9.7,5.8,3.9,6.1,3.7,2.4
08136034,Iggingen,08,Baden-Württemberg,2554,1278,1276,234,141,93,150,85,65,9.2,5.5,3.6,5.9,3.3,2.5
08136040,Leinzell,08,Baden-Württemberg,2005,1002,1003,236,155,81,159,98,61,11.8,7.7,4.0,7.9,4.9,3.0
08136049,Obergröningen,08,Baden-Württemberg,451,237,214,48,38,10,11,-1,-1,10.6,8.4,2.2,2.4,,
08136062,Schechingen,08,Baden-Württemberg,2285,1137,1148,256,154,102,137,96,41,11.2,6.7,4.5,6.0,4.2,1.8
08136007,Bartholomä,08,Baden-Württemberg,2033,1006,1027,239,150,89,205,118,87,11.8,7.4,4.4,10.1,5.8,4.3
08136009,Böbingen an der Rems,08,Baden-Württemberg,4513,2267,2246,441,286,155,302,199,103,9.8,6.3,3.4,6.7,4.4,2.3
08136028,"Heubach, Stadt",08,Baden-Württemberg,9744,4793,4951,1133,720,413,1188,731,457,11.6,7.4,4.2,12.2,7.5,4.7
08136029,Heuchlingen,08,Baden-Württemberg,1814,927,887,170,109,61,102,49,53,9.4,6.0,3.4,5.6,2.7,2.9
08136043,Mögglingen,08,Baden-Württemberg,4173,2065,2108,434,277,157,271,190,81,10.4,6.6,3.8,6.5,4.6,1.9
08136065,"Schwäbisch Gmünd, Stadt",08,Baden-Württemberg,59840,29212,30628,6232,4043,2189,6970,4530,2440,10.4,6.8,3.7,11.6,7.6,4.1
08136079,Waldstetten,08,Baden-Württemberg,7102,3495,3607,783,481,302,600,355,245,11.0,6.8,4.3,8.4,5.0,3.4
08136015,Durlangen,08,Baden-Württemberg,2936,1527,1409,332,203,129,193,143,50,11.3,6.9,4.4,6.6,4.9,1.7
08136044,Mutlangen,08,Baden-Württemberg,6588,3248,3340,675,429,246,557,329,228,10.2,6.5,3.7,8.5,5.0,3.5
08136061,Ruppertshofen,08,Baden-Württemberg,1823,949,874,193,116,77,156,91,65,10.6,6.4,4.2,8.6,5.0,3.6
08136066,Spraitbach,08,Baden-Württemberg,3302,1616,1686,365,221,144,191,104,87,11.1,6.7,4.4,5.8,3.1,2.6
08136070,Täferrot,08,Baden-Württemberg,984,500,484,135,77,58,37,14,23,13.7,7.8,5.9,3.8,1.4,2.3
08136068,Stödtlen,08,Baden-Württemberg,1872,920,952,222,157,65,109,75,34,11.9,8.4,3.5,5.8,4.0,1.8
08136071,Tannhausen,08,Baden-Württemberg,1843,899,944,197,124,73,140,86,54,10.7,6.7,4.0,7.6,4.7,2.9
08136075,Unterschneidheim,08,Baden-Württemberg,4557,2370,2187,512,307,205,315,188,127,11.2,6.7,4.5,6.9,4.1,2.8
08211000,"Baden-Baden, Stadt",08,Baden-Württemberg,54160,25769,28391,5725,3481,2244,8077,4985,3092,10.6,6.4,4.1,14.9,9.2,5.7
08212000,"Karlsruhe, Stadt",08,Baden-Württemberg,307755,156686,151069,28844,18547,10297,35363,21926,13437,9.4,6.0,3.3,11.5,7.1,4.4
08215017,"Ettlingen, Stadt",08,Baden-Württemberg,38982,18997,19985,3762,2365,1397,9364,5238,4126,9.7,6.1,3.6,24.0,13.4,10.6
08215046,Malsch,08,Baden-Württemberg,14103,7075,7028,1417,888,529,1188,702,486,10.0,6.3,3.8,8.4,5.0,3.4
08215047,Marxzell,08,Baden-Württemberg,5088,2552,2536,481,307,174,293,175,118,9.5,6.0,3.4,5.8,3.4,2.3
08215064,"Östringen, Stadt",08,Baden-Württemberg,12627,6354,6273,1224,759,465,1020,663,357,9.7,6.0,3.7,8.1,5.3,2.8
08215084,Ubstadt-Weiher,08,Baden-Württemberg,13057,6549,6508,1214,775,439,942,594,348,9.3,5.9,3.4,7.2,4.5,2.7
08215089,Walzbachtal,08,Baden-Württemberg,9642,4766,4876,813,517,296,471,288,183,8.4,5.4,3.1,4.9,3.0,1.9
08215090,Weingarten (Baden),08,Baden-Württemberg,10084,4920,5164,923,571,352,860,525,335,9.2,5.7,3.5,8.5,5.2,3.3
08215096,Karlsbad,08,Baden-Württemberg,15807,7747,8060,1625,979,646,1455,888,567,10.3,6.2,4.1,9.2,5.6,3.6
08215097,"Kraichtal, Stadt",08,Baden-Württemberg,14806,7366,7440,1399,892,507,850,553,297,9.4,6.0,3.4,5.7,3.7,2.0
08215101,Pfinztal,08,Baden-Württemberg,17914,8846,9068,1638,996,642,1112,660,452,9.1,5.6,3.6,6.2,3.7,2.5
08215102,Eggenstein-Leopoldshafen,08,Baden-Württemberg,15919,7748,8171,1559,904,655,3856,3176,680,9.8,5.7,4.1,24.2,20.0,4.3
08215105,Linkenheim-Hochstetten,08,Baden-Württemberg,11855,5883,5972,1139,676,463,642,406,236,9.6,5.7,3.9,5.4,3.4,2.0
08215106,"Waghäusel, Stadt",08,Baden-Württemberg,20629,10297,10332,2029,1268,761,1685,1036,649,9.8,6.1,3.7,8.2,5.0,3.1
08215108,"Rheinstetten, Stadt",08,Baden-Württemberg,20330,9940,10390,2049,1195,854,1515,899,616,10.1,5.9,4.2,7.5,4.4,3.0
08215109,"Stutensee, Stadt",08,Baden-Württemberg,24063,11909,12154,2122,1300,822,1853,1082,771,8.8,5.4,3.4,7.7,4.5,3.2
08215110,Waldbronn,08,Baden-Württemberg,12421,6160,6261,1245,741,504,1063,644,419,10.0,6.0,4.1,8.6,5.2,3.4
08215039,Kronau,08,Baden-Württemberg,5648,2805,2843,513,327,186,364,212,152,9.1,5.8,3.3,6.4,3.8,2.7
08215100,Bad Schönborn,08,Baden-Württemberg,12896,6489,6407,1163,728,435,1124,688,436,9.0,5.6,3.4,8.7,5.3,3.4
08215007,"Bretten, Stadt",08,Baden-Württemberg,28826,14343,14483,2741,1627,1114,2848,1774,1074,9.5,5.6,3.9,9.9,6.2,3.7
08215025,Gondelsheim,08,Baden-Württemberg,3722,1877,1845,361,212,149,205,125,80,9.7,5.7,4.0,5.5,3.4,2.1
08215009,"Bruchsal, Stadt",08,Baden-Württemberg,44104,22080,22024,4291,2593,1698,5217,3171,2046,9.7,5.9,3.8,11.8,7.2,4.6
08215021,Forst,08,Baden-Württemberg,7980,4021,3959,849,540,309,748,435,313,10.6,6.8,3.9,9.4,5.5,3.9
08215029,Hambrücken,08,Baden-Württemberg,5504,2757,2747,532,334,198,357,229,128,9.7,6.1,3.6,6.5,4.2,2.3
08215103,Karlsdorf-Neuthard,08,Baden-Württemberg,10176,5093,5083,862,499,363,687,378,309,8.5,4.9,3.6,6.8,3.7,3.0
08215099,Graben-Neudorf,08,Baden-Württemberg,11778,5851,5927,1060,665,395,735,482,253,9.0,5.6,3.4,6.2,4.1,2.1
08215111,Dettenheim,08,Baden-Württemberg,6494,3268,3226,544,348,196,434,235,199,8.4,5.4,3.0,6.7,3.6,3.1
08215040,Kürnbach,08,Baden-Württemberg,2330,1156,1174,195,121,74,171,107,64,8.4,5.2,3.2,7.3,4.6,2.7
08215059,Oberderdingen,08,Baden-Württemberg,10540,5228,5312,1041,644,397,806,504,302,9.9,6.1,3.8,7.6,4.8,2.9
08215066,"Philippsburg, Stadt",08,Baden-Württemberg,12680,6402,6278,1236,769,467,864,533,331,9.7,6.1,3.7,6.8,4.2,2.6
08215107,Oberhausen-Rheinhausen,08,Baden-Württemberg,9409,4639,4770,863,568,295,654,429,225,9.2,6.0,3.1,7.0,4.6,2.4
08215082,Sulzfeld,08,Baden-Württemberg,4741,2396,2345,455,290,165,283,176,107,9.6,6.1,3.5,6.0,3.7,2.3
08215094,Zaisenhausen,08,Baden-Württemberg,1686,869,817,187,123,64,151,93,58,11.1,7.3,3.8,9.0,5.5,3.4
08216008,Bühlertal,08,Baden-Württemberg,8085,4078,4007,884,519,365,407,256,151,10.9,6.4,4.5,5.0,3.2,1.9
08216013,Forbach,08,Baden-Württemberg,4895,2433,2462,728,557,171,288,180,108,14.9,11.4,3.5,5.9,3.7,2.2
08216015,"Gaggenau, Stadt",08,Baden-Württemberg,29032,14210,14822,2901,1846,1055,2041,1309,732,10.0,6.4,3.6,7.0,4.5,2.5
08216006,Bischweier,08,Baden-Württemberg,3031,1523,1508,312,187,125,178,109,69,10.3,6.2,4.1,5.9,3.6,2.3
08216024,"Kuppenheim, Stadt",08,Baden-Württemberg,8209,3994,4215,838,504,334,676,400,276,10.2,6.1,4.1,8.2,4.9,3.4
08216007,"Bühl, Stadt",08,Baden-Württemberg,28882,14138,14744,3366,2015,1351,3602,2090,1512,11.7,7.0,4.7,12.5,7.2,5.2
08216041,Ottersweier,08,Baden-Württemberg,6280,3183,3097,799,490,309,606,367,239,12.7,7.8,4.9,9.6,5.8,3.8
08216002,Au am Rhein,08,Baden-Württemberg,3295,1644,1651,342,219,123,227,135,92,10.4,6.6,3.7,6.9,4.1,2.8
08216005,Bietigheim,08,Baden-Württemberg,6324,3089,3235,779,495,284,561,329,232,12.3,7.8,4.5,8.9,5.2,3.7
08216009,Durmersheim,08,Baden-Württemberg,12199,5978,6221,1277,809,468,934,582,352,10.5,6.6,3.8,7.7,4.8,2.9
08216012,Elchesheim-Illingen,08,Baden-Württemberg,3208,1601,1607,350,210,140,534,402,132,10.9,6.5,4.4,16.6,12.5,4.1
08216017,"Gernsbach, Stadt",08,Baden-Württemberg,14085,6914,7171,1359,857,502,973,613,360,9.6,6.1,3.6,6.9,4.4,2.6
08216029,Loffenau,08,Baden-Württemberg,2513,1245,1268,253,158,95,151,81,70,10.1,6.3,3.8,6.0,3.2,2.8
08216059,Weisenbach,08,Baden-Württemberg,2482,1241,1241,226,160,66,176,128,48,9.1,6.4,2.7,7.1,5.2,1.9
08216023,Iffezheim,08,Baden-Württemberg,4927,2471,2456,610,359,251,583,345,238,12.4,7.3,5.1,11.8,7.0,4.8
08216033,Muggensturm,08,Baden-Württemberg,6179,3056,3123,543,327,216,703,391,312,8.8,5.3,3.5,11.4,6.3,5.0
08216039,Ötigheim,08,Baden-Württemberg,4651,2342,2309,446,289,157,641,257,384,9.6,6.2,3.4,13.8,5.5,8.3
08216043,"Rastatt, Stadt",08,Baden-Württemberg,48051,23673,24378,5490,3176,2314,4871,2763,2108,11.4,6.6,4.8,10.1,5.8,4.4
08216052,Steinmauern,08,Baden-Württemberg,3076,1556,1520,320,180,140,165,97,68,10.4,5.9,4.6,5.4,3.2,2.2
08216028,"Lichtenau, Stadt",08,Baden-Württemberg,4973,2494,2479,582,349,233,438,285,153,11.7,7.0,4.7,8.8,5.7,3.1
08216063,Rheinmünster,08,Baden-Württemberg,6825,3455,3370,792,456,336,647,364,283,11.6,6.7,4.9,9.5,5.3,4.1
08216022,Hügelsheim,08,Baden-Württemberg,5153,2682,2471,669,378,291,285,170,115,13.0,7.3,5.6,5.5,3.3,2.2
08216049,Sinzheim,08,Baden-Württemberg,11119,5509,5610,1318,772,546,1055,598,457,11.9,6.9,4.9,9.5,5.4,4.1
08221000,"Heidelberg, Stadt",08,Baden-Württemberg,156267,74954,81313,14606,10547,4059,20434,14301,6133,9.3,6.7,2.6,13.1,9.2,3.9
08222000,"Mannheim, Universitätsstadt",08,Baden-Württemberg,305780,152868,152912,28767,18637,10130,34644,22483,12161,9.4,6.1,3.3,11.3,7.4,4.0
08225014,"Buchen (Odenwald), Stadt",08,Baden-Württemberg,17704,8672,9032,1787,1131,656,1888,1229,659,10.1,6.4,3.7,10.7,6.9,3.7
08225060,Mudau,08,Baden-Württemberg,4880,2462,2418,539,351,188,430,266,164,11.0,7.2,3.9,8.8,5.5,3.4
08225032,Hardheim,08,Baden-Württemberg,6936,3515,3421,644,393,251,524,336,188,9.3,5.7,3.6,7.6,4.8,2.7
08225039,Höpfingen,08,Baden-Württemberg,2993,1495,1498,293,176,117,121,72,49,9.8,5.9,3.9,4.0,2.4,1.6
08225109,"Walldürn, Stadt",08,Baden-Württemberg,11506,5851,5655,1164,763,401,1070,666,404,10.1,6.6,3.5,9.3,5.8,3.5
08225033,Haßmersheim,08,Baden-Württemberg,4877,2446,2431,507,324,183,263,184,79,10.4,6.6,3.8,5.4,3.8,1.6
08225042,Hüffenhardt,08,Baden-Württemberg,2046,1008,1038,187,119,68,104,61,43,9.1,5.8,3.3,5.1,3.0,2.1
08225002,Aglasterhausen,08,Baden-Württemberg,4819,2368,2451,507,310,197,437,269,168,10.5,6.4,4.1,9.1,5.6,3.5
08225068,Neunkirchen,08,Baden-Württemberg,1802,880,922,164,95,69,112,66,46,9.1,5.3,3.8,6.2,3.7,2.6
08225116,Schwarzach,08,Baden-Württemberg,2863,1520,1343,240,143,97,213,133,80,8.4,5.0,3.4,7.4,4.6,2.8
08225024,Fahrenbach,08,Baden-Württemberg,2747,1350,1397,310,203,107,176,108,68,11.3,7.4,3.9,6.4,3.9,2.5
08225052,Limbach,08,Baden-Württemberg,4442,2241,2201,438,277,161,377,229,148,9.9,6.2,3.6,8.5,5.2,3.3
08225058,"Mosbach, Stadt",08,Baden-Württemberg,23000,11330,11670,2422,1541,881,2950,1925,1025,10.5,6.7,3.8,12.8,8.4,4.5
08225067,Neckarzimmern,08,Baden-Württemberg,1499,738,761,153,93,60,79,50,29,10.2,6.2,4.0,5.3,3.3,1.9
08225074,Obrigheim,08,Baden-Württemberg,5324,2681,2643,521,314,207,508,326,182,9.8,5.9,3.9,9.5,6.1,3.4
08225117,Elztal,08,Baden-Württemberg,5895,2957,2938,600,362,238,474,267,207,10.2,6.1,4.0,8.0,4.5,3.5
08225010,Binau,08,Baden-Württemberg,1370,712,658,129,80,49,97,65,32,9.4,5.8,3.6,7.1,4.7,2.3
08225064,Neckargerach,08,Baden-Württemberg,2315,1141,1174,217,141,76,100,70,30,9.4,6.1,3.3,4.3,3.0,1.3
08225113,Zwingenberg,08,Baden-Württemberg,702,357,345,54,36,18,25,17,8,7.7,5.1,2.6,3.6,2.4,1.1
08225118,Waldbrunn,08,Baden-Württemberg,4702,2278,2424,468,305,163,302,197,105,10.0,6.5,3.5,6.4,4.2,2.2
08225075,"Osterburken, Stadt",08,Baden-Württemberg,6544,3303,3241,655,384,271,645,408,237,10.0,5.9,4.1,9.9,6.2,3.6
08225082,Rosenberg,08,Baden-Württemberg,2118,1062,1056,222,152,70,182,111,71,10.5,7.2,3.3,8.6,5.2,3.4
08225114,"Ravenstein, Stadt",08,Baden-Württemberg,2825,1449,1376,327,212,115,195,118,77,11.6,7.5,4.1,6.9,4.2,2.7
08225009,Billigheim,08,Baden-Württemberg,5900,3011,2889,564,363,201,344,218,126,9.6,6.2,3.4,5.8,3.7,2.1
08225115,Schefflenz,08,Baden-Württemberg,3955,1967,1988,373,250,123,239,147,92,9.4,6.3,3.1,6.0,3.7,2.3
08225001,"Adelsheim, Stadt",08,Baden-Württemberg,5016,2659,2357,479,325,154,351,237,114,9.5,6.5,3.1,7.0,4.7,2.3
08225091,Seckach,08,Baden-Württemberg,4156,2143,2013,423,295,128,318,225,93,10.2,7.1,3.1,7.7,5.4,2.2
08226009,Brühl,08,Baden-Württemberg,13941,6647,7294,1285,804,481,952,625,327,9.2,5.8,3.5,6.8,4.5,2.3
08226012,Dossenheim,08,Baden-Württemberg,12504,5971,6533,1190,821,369,649,406,243,9.5,6.6,3.0,5.2,3.2,1.9
08226018,"Eppelheim, Stadt",08,Baden-Württemberg,15177,7460,7717,1742,1081,661,1051,651,400,11.5,7.1,4.4,6.9,4.3,2.6
08226028,Heddesheim,08,Baden-Württemberg,11199,5387,5812,1039,680,359,906,519,387,9.3,6.1,3.2,8.1,4.6,3.5
08226036,Ilvesheim,08,Baden-Württemberg,9100,4415,4685,740,453,287,564,379,185,8.1,5.0,3.2,6.2,4.2,2.0
08226037,Ketsch,08,Baden-Württemberg,12555,6077,6478,1128,718,410,1264,751,513,9.0,5.7,3.3,10.1,6.0,4.1
08226038,"Ladenburg, Stadt",08,Baden-Württemberg,11420,5528,5892,1027,665,362,1247,797,450,9.0,5.8,3.2,10.9,7.0,3.9
08226041,"Leimen, Stadt",08,Baden-Württemberg,26910,13269,13641,2979,1815,1164,1700,1051,649,11.1,6.7,4.3,6.3,3.9,2.4
08226060,Nußloch,08,Baden-Württemberg,10910,5426,5484,1059,655,404,756,476,280,9.7,6.0,3.7,6.9,4.4,2.6
08226062,Oftersheim,08,Baden-Württemberg,12010,5799,6211,1099,685,414,497,328,169,9.2,5.7,3.4,4.1,2.7,1.4
08226063,Plankstadt,08,Baden-Württemberg,10176,4914,5262,960,587,373,785,524,261,9.4,5.8,3.7,7.7,5.1,2.6
08226076,Sandhausen,08,Baden-Württemberg,14902,7260,7642,1462,873,589,812,469,343,9.8,5.9,4.0,5.4,3.1,2.3
08226082,"Schriesheim, Stadt",08,Baden-Württemberg,14901,7202,7699,1315,868,447,1042,682,360,8.8,5.8,3.0,7.0,4.6,2.4
08226084,"Schwetzingen, Stadt",08,Baden-Württemberg,22335,11048,11287,2083,1315,768,2748,1699,1049,9.3,5.9,3.4,12.3,7.6,4.7
08226095,"Walldorf, Stadt",08,Baden-Württemberg,15559,7853,7706,1419,899,520,1967,1318,649,9.1,5.8,3.3,12.6,8.5,4.2
08226096,"Weinheim, Stadt",08,Baden-Württemberg,44797,21935,22862,4166,2680,1486,6303,4203,2100,9.3,6.0,3.3,14.1,9.4,4.7
08226103,St. Leon-Rot,08,Baden-Württemberg,13560,6743,6817,1262,770,492,2692,2024,668,9.3,5.7,3.6,19.9,14.9,4.9
08226105,Edingen-Neckarhausen,08,Baden-Württemberg,13959,6726,7233,1207,797,410,822,542,280,8.6,5.7,2.9,5.9,3.9,2.0
08226107,Hirschberg an der Bergstraße,08,Baden-Württemberg,9647,4638,5009,789,514,275,707,442,265,8.2,5.3,2.9,7.3,4.6,2.7
08226013,"Eberbach, Stadt",08,Baden-Württemberg,14751,7082,7669,1290,837,453,1107,726,381,8.7,5.7,3.1,7.5,4.9,2.6
08226081,Schönbrunn,08,Baden-Württemberg,2842,1423,1419,279,180,99,106,62,44,9.8,6.3,3.5,3.7,2.2,1.5
08226020,Eschelbronn,08,Baden-Württemberg,2645,1341,1304,264,182,82,179,122,57,10.0,6.9,3.1,6.8,4.6,2.2
08226048,Mauer,08,Baden-Württemberg,3949,1897,2052,415,244,171,331,206,125,10.5,6.2,4.3,8.4,5.2,3.2
08226049,Meckesheim,08,Baden-Württemberg,5044,2530,2514,540,337,203,648,459,189,10.7,6.7,4.0,12.8,9.1,3.7
08226086,Spechbach,08,Baden-Württemberg,1799,899,900,195,137,58,108,75,33,10.8,7.6,3.2,6.0,4.2,1.8
08226104,Lobbach,08,Baden-Württemberg,2364,1182,1182,304,192,112,296,181,115,12.9,8.1,4.7,12.5,7.7,4.9
08226031,"Hemsbach, Stadt",08,Baden-Württemberg,12050,5947,6103,1160,768,392,773,513,260,9.6,6.4,3.3,6.4,4.3,2.2
08226040,Laudenbach,08,Baden-Württemberg,6097,3053,3044,576,390,186,277,189,88,9.4,6.4,3.1,4.5,3.1,1.4
08226003,Altlußheim,08,Baden-Württemberg,5708,2831,2877,543,355,188,512,369,143,9.5,6.2,3.3,9.0,6.5,2.5
08226032,"Hockenheim, Stadt",08,Baden-Württemberg,21130,10388,10742,2045,1313,732,1859,1226,633,9.7,6.2,3.5,8.8,5.8,3.0
08226059,Neulußheim,08,Baden-Württemberg,6783,3390,3393,626,403,223,286,210,76,9.2,5.9,3.3,4.2,3.1,1.1
08226068,Reilingen,08,Baden-Württemberg,7437,3715,3722,669,403,266,466,293,173,9.0,5.4,3.6,6.3,3.9,2.3
08226006,Bammental,08,Baden-Württemberg,6426,3068,3358,628,437,191,559,364,195,9.8,6.8,3.0,8.7,5.7,3.0
08226022,Gaiberg,08,Baden-Württemberg,2380,1175,1205,192,132,60,96,57,39,8.1,5.5,2.5,4.0,2.4,1.6
08226056,"Neckargemünd, Stadt",08,Baden-Württemberg,13369,6531,6838,1161,763,398,989,616,373,8.7,5.7,3.0,7.4,4.6,2.8
08226097,Wiesenbach,08,Baden-Württemberg,3093,1512,1581,313,200,113,298,188,110,10.1,6.5,3.7,9.6,6.1,3.6
08226046,Malsch,08,Baden-Württemberg,3443,1711,1732,297,191,106,196,114,82,8.6,5.5,3.1,5.7,3.3,2.4
08226054,Mühlhausen,08,Baden-Württemberg,8451,4238,4213,818,515,303,585,370,215,9.7,6.1,3.6,6.9,4.4,2.5
08226065,"Rauenberg, Stadt",08,Baden-Württemberg,8593,4264,4329,740,440,300,506,319,187,8.6,5.1,3.5,5.9,3.7,2.2
08226027,Heddesbach,08,Baden-Württemberg,475,240,235,63,41,22,40,28,12,13.3,8.6,4.6,8.4,5.9,2.5
08226029,Heiligkreuzsteinach,08,Baden-Württemberg,2592,1280,1312,270,170,100,177,115,62,10.4,6.6,3.9,6.8,4.4,2.4
08226080,"Schönau, Stadt",08,Baden-Württemberg,4370,2190,2180,367,248,119,192,127,65,8.4,5.7,2.7,4.4,2.9,1.5
08226099,Wilhelmsfeld,08,Baden-Württemberg,3197,1549,1648,270,180,90,244,164,80,8.4,5.6,2.8,7.6,5.1,2.5
08226085,"Sinsheim, Stadt",08,Baden-Württemberg,35175,17504,17671,3936,2514,1422,4829,2931,1898,11.2,7.1,4.0,13.7,8.3,5.4
08226101,Zuzenhausen,08,Baden-Württemberg,2153,1074,1079,253,169,84,300,195,105,11.8,7.8,3.9,13.9,9.1,4.9
08226102,Angelbachtal,08,Baden-Württemberg,4929,2375,2554,446,278,168,222,149,73,9.0,5.6,3.4,4.5,3.0,1.5
08226017,Epfenbach,08,Baden-Württemberg,2429,1228,1201,251,144,107,131,71,60,10.3,5.9,4.4,5.4,2.9,2.5
08226055,"Neckarbischofsheim, Stadt",08,Baden-Württemberg,3983,1986,1997,419,276,143,263,184,79,10.5,6.9,3.6,6.6,4.6,2.0
08226058,Neidenstein,08,Baden-Württemberg,1779,888,891,162,106,56,134,74,60,9.1,6.0,3.1,7.5,4.2,3.4
08226066,Reichartshausen,08,Baden-Württemberg,2085,1039,1046,241,147,94,109,65,44,11.6,7.1,4.5,5.2,3.1,2.1
08226091,"Waibstadt, Stadt",08,Baden-Württemberg,5735,2835,2900,549,330,219,438,251,187,9.6,5.8,3.8,7.6,4.4,3.3
08226106,Helmstadt-Bargen,08,Baden-Württemberg,3762,1910,1852,348,199,149,337,211,126,9.3,5.3,4.0,9.0,5.6,3.3
08226010,Dielheim,08,Baden-Württemberg,8853,4371,4482,864,548,316,449,279,170,9.8,6.2,3.6,5.1,3.2,1.9
08226098,"Wiesloch, Stadt",08,Baden-Württemberg,26426,13184,13242,2605,1638,967,2574,1651,923,9.9,6.2,3.7,9.7,6.2,3.5
08231000,"Pforzheim, Stadt",08,Baden-Württemberg,122247,59901,62346,12356,7344,5012,13559,8246,5313,10.1,6.0,4.1,11.1,6.7,4.3
08235065,Schömberg,08,Baden-Württemberg,8097,4033,4064,816,487,329,608,376,232,10.1,6.0,4.1,7.5,4.6,2.9
08235080,"Wildberg, Stadt",08,Baden-Württemberg,9895,4945,4950,982,573,409,572,341,231,9.9,5.8,4.1,5.8,3.4,2.3
08235006,"Altensteig, Stadt",08,Baden-Württemberg,10300,5141,5159,1249,735,514,1139,681,458,12.1,7.1,5.0,11.1,6.6,4.4
08235022,Egenhausen,08,Baden-Württemberg,1997,1007,990,285,171,114,183,115,68,14.3,8.6,5.7,9.2,5.8,3.4
08235066,Simmersfeld,08,Baden-Württemberg,2093,1084,1009,271,159,112,214,106,108,12.9,7.6,5.4,10.2,5.1,5.2
08235007,Althengstett,08,Baden-Württemberg,7867,3960,3907,780,454,326,661,388,273,9.9,5.8,4.1,8.4,4.9,3.5
08235029,Gechingen,08,Baden-Württemberg,3755,1865,1890,324,195,129,232,126,106,8.6,5.2,3.4,6.2,3.4,2.8
08235057,Ostelsheim,08,Baden-Württemberg,2375,1181,1194,236,148,88,188,133,55,9.9,6.2,3.7,7.9,5.6,2.3
08235067,Simmozheim,08,Baden-Württemberg,2894,1459,1435,308,178,130,196,96,100,10.6,6.2,4.5,6.8,3.3,3.5
08235018,Dobel,08,Baden-Württemberg,2197,1082,1115,228,142,86,159,94,65,10.4,6.5,3.9,7.2,4.3,3.0
08235033,"Bad Herrenalb, Stadt",08,Baden-Württemberg,7641,3740,3901,813,481,332,560,317,243,10.6,6.3,4.3,7.3,4.1,3.2
08235008,"Bad Liebenzell, Stadt",08,Baden-Württemberg,9298,4526,4772,943,541,402,792,458,334,10.1,5.8,4.3,8.5,4.9,3.6
08235073,Unterreichenbach,08,Baden-Württemberg,2333,1169,1164,263,155,108,148,81,67,11.3,6.6,4.6,6.3,3.5,2.9
08235047,"Neubulach, Stadt",08,Baden-Württemberg,5517,2741,2776,635,401,234,536,342,194,11.5,7.3,4.2,9.7,6.2,3.5
08235050,Neuweiler,08,Baden-Württemberg,3107,1616,1491,338,202,136,222,105,117,10.9,6.5,4.4,7.1,3.4,3.8
08235084,"Bad Teinach-Zavelstein, Stadt",08,Baden-Württemberg,3073,1590,1483,333,201,132,222,138,84,10.8,6.5,4.3,7.2,4.5,2.7
08235055,Oberreichenbach,08,Baden-Württemberg,2757,1394,1363,274,167,107,190,120,70,9.9,6.1,3.9,6.9,4.4,2.5
08235085,"Calw, Stadt",08,Baden-Württemberg,23232,11748,11484,2495,1466,1029,2519,1414,1105,10.7,6.3,4.4,10.8,6.1,4.8
08235020,Ebhausen,08,Baden-Württemberg,4765,2429,2336,555,283,272,278,154,124,11.6,5.9,5.7,5.8,3.2,2.6
08235032,"Haiterbach, Stadt",08,Baden-Württemberg,5778,2886,2892,748,419,329,593,308,285,12.9,7.3,5.7,10.3,5.3,4.9
08235046,"Nagold, Stadt",08,Baden-Württemberg,21687,10705,10982,2650,1590,1060,3233,1836,1397,12.2,7.3,4.9,14.9,8.5,6.4
08235060,Rohrdorf,08,Baden-Württemberg,1929,980,949,249,141,108,134,69,65,12.9,7.3,5.6,6.9,3.6,3.4
08235025,Enzklösterle,08,Baden-Württemberg,1171,588,583,142,95,47,105,61,44,12.1,8.1,4.0,9.0,5.2,3.8
08235035,Höfen an der Enz,08,Baden-Württemberg,1725,888,837,189,112,77,178,105,73,11.0,6.5,4.5,10.3,6.1,4.2
08235079,"Bad Wildbad, Stadt",08,Baden-Württemberg,9876,4926,4950,1065,625,440,875,521,354,10.8,6.3,4.5,8.9,5.3,3.6
08236004,Birkenfeld,08,Baden-Württemberg,10224,5024,5200,1034,597,437,900,518,382,10.1,5.8,4.3,8.8,5.1,3.7
08236028,Illingen,08,Baden-Württemberg,7420,3673,3747,751,467,284,658,399,259,10.1,6.3,3.8,8.9,5.4,3.5
08236030,Ispringen,08,Baden-Württemberg,6072,2955,3117,595,348,247,470,306,164,9.8,5.7,4.1,7.7,5.0,2.7
08236033,"Knittlingen, Stadt",08,Baden-Württemberg,7903,3896,4007,819,486,333,592,362,230,10.4,6.1,4.2,7.5,4.6,2.9
08236046,Niefern-Öschelbronn,08,Baden-Württemberg,11986,5894,6092,1256,731,525,996,581,415,10.5,6.1,4.4,8.3,4.8,3.5
08236070,Keltern,08,Baden-Württemberg,9211,4461,4750,925,560,365,928,556,372,10.0,6.1,4.0,10.1,6.0,4.0
08236071,Remchingen,08,Baden-Württemberg,11748,5774,5974,1208,753,455,856,506,350,10.3,6.4,3.9,7.3,4.3,3.0
08236072,Straubenhardt,08,Baden-Württemberg,10938,5438,5500,1135,639,496,886,521,365,10.4,5.8,4.5,8.1,4.8,3.3
08236019,Friolzheim,08,Baden-Württemberg,3948,1942,2006,389,221,168,337,192,145,9.9,5.6,4.3,8.5,4.9,3.7
08236025,"Heimsheim, Stadt",08,Baden-Württemberg,5061,2740,2321,456,266,190,505,284,221,9.0,5.3,3.8,10.0,5.6,4.4
08236039,Mönsheim,08,Baden-Württemberg,2783,1467,1316,295,168,127,230,123,107,10.6,6.0,4.6,8.3,4.4,3.8
08236065,Wiernsheim,08,Baden-Württemberg,6682,3363,3319,706,415,291,554,307,247,10.6,6.2,4.4,8.3,4.6,3.7
08236067,Wimsheim,08,Baden-Württemberg,2815,1412,1403,271,139,132,228,121,107,9.6,4.9,4.7,8.1,4.3,3.8
08236068,Wurmberg,08,Baden-Württemberg,3105,1536,1569,312,172,140,318,163,155,10.0,5.5,4.5,10.2,5.2,5.0
08236011,Eisingen,08,Baden-Württemberg,4674,2229,2445,488,285,203,265,156,109,10.4,6.1,4.3,5.7,3.3,2.3
08236074,Kämpfelbach,08,Baden-Württemberg,6273,3126,3147,566,336,230,323,179,144,9.0,5.4,3.7,5.1,2.9,2.3
08236076,Königsbach-Stein,08,Baden-Württemberg,9890,4892,4998,883,507,376,718,453,265,8.9,5.1,3.8,7.3,4.6,2.7
08236038,"Maulbronn, Stadt",08,Baden-Württemberg,6463,3184,3279,682,408,274,1031,479,552,10.6,6.3,4.2,16.0,7.4,8.5
08236061,Sternenfels,08,Baden-Württemberg,2724,1352,1372,285,169,116,262,156,106,10.5,6.2,4.3,9.6,5.7,3.9
08236040,"Mühlacker, Stadt",08,Baden-Württemberg,25649,12753,12896,2820,1698,1122,2872,1761,1111,11.0,6.6,4.4,11.2,6.9,4.3
08236050,Ötisheim,08,Baden-Württemberg,4736,2349,2387,531,315,216,484,283,201,11.2,6.7,4.6,10.2,6.0,4.2
08236013,Engelsbrand,08,Baden-Württemberg,4339,2121,2218,412,260,152,265,145,120,9.5,6.0,3.5,6.1,3.3,2.8
08236043,"Neuenbürg, Stadt",08,Baden-Württemberg,7903,3965,3938,725,408,317,575,334,241,9.2,5.2,4.0,7.3,4.2,3.0
08236031,Kieselbronn,08,Baden-Württemberg,2965,1451,1514,288,168,120,131,82,49,9.7,5.7,4.0,4.4,2.8,1.7
08236073,Neulingen,08,Baden-Württemberg,6815,3318,3497,679,416,263,488,332,156,10.0,6.1,3.9,7.2,4.9,2.3
08236075,Ölbronn-Dürrn,08,Baden-Württemberg,3395,1686,1709,357,214,143,250,138,112,10.5,6.3,4.2,7.4,4.1,3.3
08236044,Neuhausen,08,Baden-Württemberg,5228,2564,2664,519,329,190,329,201,128,9.9,6.3,3.6,6.3,3.8,2.4
08236062,Tiefenbronn,08,Baden-Württemberg,5116,2535,2581,458,293,165,346,207,139,9.0,5.7,3.2,6.8,4.0,2.7
08237002,"Alpirsbach, Stadt",08,Baden-Württemberg,6337,3199,3138,849,521,328,699,416,283,13.4,8.2,5.2,11.0,6.6,4.5
08237004,Baiersbronn,08,Baden-Württemberg,14667,7236,7431,1914,1193,721,1757,1103,654,13.0,8.1,4.9,12.0,7.5,4.5
08237045,Loßburg,08,Baden-Württemberg,7446,3747,3699,881,505,376,765,458,307,11.8,6.8,5.0,10.3,6.2,4.1
08237019,"Dornstetten, Stadt",08,Baden-Württemberg,7992,3951,4041,984,581,403,859,530,329,12.3,7.3,5.0,10.7,6.6,4.1
08237030,Glatten,08,Baden-Württemberg,2343,1189,1154,311,205,106,286,174,112,13.3,8.7,4.5,12.2,7.4,4.8
08237061,Schopfloch,08,Baden-Württemberg,2599,1304,1295,324,202,122,243,144,99,12.5,7.8,4.7,9.3,5.5,3.8
08237074,Waldachtal,08,Baden-Württemberg,5835,2965,2870,653,391,262,603,385,218,11.2,6.7,4.5,10.3,6.6,3.7
08237028,"Freudenstadt, Stadt",08,Baden-Württemberg,22579,10927,11652,2624,1523,1101,2667,1564,1103,11.6,6.7,4.9,11.8,6.9,4.9
08237073,Seewald,08,Baden-Württemberg,2151,1052,1099,260,142,118,241,129,112,12.1,6.6,5.5,11.2,6.0,5.2
08237075,Bad Rippoldsau-Schapbach,08,Baden-Württemberg,2121,1066,1055,236,142,94,187,109,78,11.1,6.7,4.4,8.8,5.1,3.7
08237024,Empfingen,08,Baden-Württemberg,3979,2002,1977,532,301,231,673,398,275,13.4,7.6,5.8,16.9,10.0,6.9
08237027,Eutingen im Gäu,08,Baden-Württemberg,5568,2849,2719,609,367,242,554,322,232,10.9,6.6,4.3,9.9,5.8,4.2
08237040,"Horb am Neckar, Stadt",08,Baden-Württemberg,24665,12424,12241,2797,1711,1086,2558,1612,946,11.3,6.9,4.4,10.4,6.5,3.8
08237032,Grömbach,08,Baden-Württemberg,612,318,294,70,49,21,-1,-1,-1,11.4,8.0,3.4,-0.2,,
08237054,Pfalzgrafenweiler,08,Baden-Württemberg,7101,3526,3575,918,543,375,801,460,341,12.9,7.6,5.3,11.3,6.5,4.8
08237072,Wörnersberg,08,Baden-Württemberg,238,111,127,30,15,15,-1,-1,-1,12.6,6.3,6.3,-0.4,,
08311000,"Freiburg im Breisgau, Stadt",08,Baden-Württemberg,226393,107913,118480,25562,17230,8332,31164,20832,10332,11.3,7.6,3.7,13.8,9.2,4.6
08315068,Lenzkirch,08,Baden-Württemberg,4970,2443,2527,594,341,253,407,242,165,12.0,6.9,5.1,8.2,4.9,3.3
08315076,"Neuenburg am Rhein, Stadt",08,Baden-Württemberg,12081,5996,6085,1482,882,600,967,609,358,12.3,7.3,5.0,8.0,5.0,3.0
08315133,"Vogtsburg im Kaiserstuhl, Stadt",08,Baden-Württemberg,5888,2952,2936,705,437,268,612,392,220,12.0,7.4,4.6,10.4,6.7,3.7
08315006,"Bad Krozingen, Stadt",08,Baden-Württemberg,18692,9010,9682,2169,1244,925,2547,1462,1085,11.6,6.7,4.9,13.6,7.8,5.8
08315048,Hartheim am Rhein,08,Baden-Württemberg,4912,2569,2343,608,342,266,358,202,156,12.4,7.0,5.4,7.3,4.1,3.2
08315015,"Breisach am Rhein, Stadt",08,Baden-Württemberg,15315,7580,7735,1834,1096,738,1994,1144,850,12.0,7.2,4.8,13.0,7.5,5.6
08315059,Ihringen,08,Baden-Württemberg,5993,2935,3058,756,484,272,655,397,258,12.6,8.1,4.5,10.9,6.6,4.3
08315072,Merdingen,08,Baden-Württemberg,2579,1239,1340,325,169,156,176,108,68,12.6,6.6,6.0,6.8,4.2,2.6
08315020,Buchenbach,08,Baden-Württemberg,3081,1532,1549,443,256,187,268,168,100,14.4,8.3,6.1,8.7,5.5,3.2
08315064,Kirchzarten,08,Baden-Württemberg,9898,4724,5174,1046,685,361,1212,786,426,10.6,6.9,3.6,12.2,7.9,4.3
08315084,Oberried,08,Baden-Württemberg,2855,1429,1426,433,266,167,312,185,127,15.2,9.3,5.8,10.9,6.5,4.4
08315109,Stegen,08,Baden-Württemberg,4481,2209,2272,494,308,186,285,163,122,11.0,6.9,4.2,6.4,3.6,2.7
08315014,Bollschweil,08,Baden-Württemberg,2337,1167,1170,239,147,92,147,89,58,10.2,6.3,3.9,6.3,3.8,2.5
08315131,Ehrenkirchen,08,Baden-Württemberg,7253,3633,3620,856,518,338,667,400,267,11.8,7.1,4.7,9.2,5.5,3.7
08315047,Gundelfingen,08,Baden-Württemberg,11555,5536,6019,1105,673,432,940,533,407,9.6,5.8,3.7,8.1,4.6,3.5
08315051,Heuweiler,08,Baden-Württemberg,1143,560,583,112,76,36,87,47,40,9.8,6.6,3.1,7.6,4.1,3.5
08315008,Ballrechten-Dottingen,08,Baden-Württemberg,2379,1178,1201,297,175,122,120,75,45,12.5,7.4,5.1,5.0,3.2,1.9
08315033,Eschbach,08,Baden-Württemberg,2746,1453,1293,324,198,126,376,234,142,11.8,7.2,4.6,13.7,8.5,5.2
08315050,"Heitersheim, Stadt",08,Baden-Württemberg,6139,3018,3121,690,425,265,682,416,266,11.2,6.9,4.3,11.1,6.8,4.3
08315003,Au,08,Baden-Württemberg,1402,694,708,125,81,44,95,60,35,8.9,5.8,3.1,6.8,4.3,2.5
08315056,Horben,08,Baden-Württemberg,1129,561,568,103,62,41,74,43,31,9.1,5.5,3.6,6.6,3.8,2.7
08315073,Merzhausen,08,Baden-Württemberg,5211,2541,2670,456,318,138,352,243,109,8.8,6.1,2.6,6.8,4.7,2.1
08315107,Sölden,08,Baden-Württemberg,1281,608,673,123,75,48,108,66,42,9.6,5.9,3.7,8.4,5.2,3.3
08315125,Wittnau,08,Baden-Württemberg,1475,743,732,148,104,44,77,51,26,10.0,7.1,3.0,5.2,3.5,1.8
08315016,Breitnau,08,Baden-Württemberg,1729,856,873,231,143,88,159,93,66,13.4,8.3,5.1,9.2,5.4,3.8
08315052,Hinterzarten,08,Baden-Württemberg,2514,1234,1280,255,179,76,398,264,134,10.1,7.1,3.0,15.8,10.5,5.3
08315013,Bötzingen,08,Baden-Württemberg,5325,2619,2706,660,386,274,534,343,191,12.4,7.2,5.1,10.0,6.4,3.6
08315030,Eichstetten am Kaiserstuhl,08,Baden-Württemberg,3528,1738,1790,422,268,154,276,182,94,12.0,7.6,4.4,7.8,5.2,2.7
08315043,Gottenheim,08,Baden-Württemberg,2815,1390,1425,305,171,134,185,110,75,10.8,6.1,4.8,6.6,3.9,2.7
08315039,Friedenweiler,08,Baden-Württemberg,1930,967,963,211,136,75,124,74,50,10.9,7.0,3.9,6.4,3.8,2.6
08315070,"Löffingen, Stadt",08,Baden-Württemberg,7564,3774,3790,875,553,322,671,423,248,11.6,7.3,4.3,8.9,5.6,3.3
08315115,Umkirch,08,Baden-Württemberg,5400,2699,2701,723,411,312,900,496,404,13.4,7.6,5.8,16.7,9.2,7.5
08315132,March,08,Baden-Württemberg,9007,4488,4519,1128,645,483,1012,608,404,12.5,7.2,5.4,11.2,6.8,4.5
08315004,Auggen,08,Baden-Württemberg,2681,1316,1365,298,191,107,267,171,96,11.1,7.1,4.0,10.0,6.4,3.6
08315007,Badenweiler,08,Baden-Württemberg,4165,1995,2170,420,261,159,532,317,215,10.1,6.3,3.8,12.8,7.6,5.2
08315022,Buggingen,08,Baden-Württemberg,4091,2014,2077,464,284,180,408,221,187,11.3,6.9,4.4,10.0,5.4,4.6
08315074,"Müllheim, Stadt",08,Baden-Württemberg,18664,9025,9639,2031,1199,832,2052,1250,802,10.9,6.4,4.5,11.0,6.7,4.3
08315111,"Sulzburg, Stadt",08,Baden-Württemberg,2672,1268,1404,262,174,88,197,140,57,9.8,6.5,3.3,7.4,5.2,2.1
08315041,Glottertal,08,Baden-Württemberg,3214,1593,1621,369,226,143,301,186,115,11.5,7.0,4.4,9.4,5.8,3.6
08315094,St. Märgen,08,Baden-Württemberg,1856,943,913,268,165,103,195,118,77,14.4,8.9,5.5,10.5,6.4,4.1
08315095,St. Peter,08,Baden-Württemberg,2583,1296,1287,339,203,136,276,177,99,13.1,7.9,5.3,10.7,6.9,3.8
08315028,Ebringen,08,Baden-Württemberg,2802,1399,1403,326,206,120,242,139,103,11.6,7.4,4.3,8.6,5.0,3.7
08315089,Pfaffenweiler,08,Baden-Württemberg,2568,1262,1306,316,205,111,173,105,68,12.3,8.0,4.3,6.7,4.1,2.6
08315098,Schallstadt,08,Baden-Württemberg,6109,2998,3111,636,391,245,750,408,342,10.4,6.4,4.0,12.3,6.7,5.6
08315037,Feldberg (Schwarzwald),08,Baden-Württemberg,1912,995,917,226,132,94,277,153,124,11.8,6.9,4.9,14.5,8.0,6.5
08315102,Schluchsee,08,Baden-Württemberg,2440,1207,1233,292,187,105,317,195,122,12.0,7.7,4.3,13.0,8.0,5.0
08315108,"Staufen im Breisgau, Stadt",08,Baden-Württemberg,7726,3632,4094,837,537,300,841,549,292,10.8,7.0,3.9,10.9,7.1,3.8
08315130,Münstertal/Schwarzwald,08,Baden-Württemberg,5045,2520,2525,691,469,222,489,326,163,13.7,9.3,4.4,9.7,6.5,3.2
08315031,Eisenbach (Hochschwarzwald),08,Baden-Württemberg,2125,1083,1042,256,157,99,201,131,70,12.0,7.4,4.7,9.5,6.2,3.3
08315113,"Titisee-Neustadt, Stadt",08,Baden-Württemberg,12083,5964,6119,1560,906,654,1882,1129,753,12.9,7.5,5.4,15.6,9.3,6.2
08316009,Denzlingen,08,Baden-Württemberg,13498,6490,7008,1508,937,571,1225,796,429,11.2,6.9,4.2,9.1,5.9,3.2
08316036,Reute,08,Baden-Württemberg,2926,1459,1467,361,196,165,169,92,77,12.3,6.7,5.6,5.8,3.1,2.6
08316045,Vörstetten,08,Baden-Württemberg,2985,1470,1515,307,190,117,415,220,195,10.3,6.4,3.9,13.9,7.4,6.5
08316003,Biederbach,08,Baden-Württemberg,1763,915,848,214,132,82,117,68,49,12.1,7.5,4.7,6.6,3.9,2.8
08316010,"Elzach, Stadt",08,Baden-Württemberg,7161,3535,3626,953,543,410,1018,584,434,13.3,7.6,5.7,14.2,8.2,6.1
08316055,Winden im Elztal,08,Baden-Württemberg,2860,1453,1407,361,207,154,258,156,102,12.6,7.2,5.4,9.0,5.5,3.6
08316011,"Emmendingen, Stadt",08,Baden-Württemberg,27383,13303,14080,3048,1775,1273,3324,1960,1364,11.1,6.5,4.6,12.1,7.2,5.0
08316024,Malterdingen,08,Baden-Württemberg,3162,1569,1593,333,204,129,243,154,89,10.5,6.5,4.1,7.7,4.9,2.8
08316039,Sexau,08,Baden-Württemberg,3303,1612,1691,392,225,167,369,188,181,11.9,6.8,5.1,11.2,5.7,5.5
08316043,Teningen,08,Baden-Württemberg,11696,5794,5902,1234,739,495,1246,634,612,10.6,6.3,4.2,10.7,5.4,5.2
08316054,Freiamt,08,Baden-Württemberg,4169,2088,2081,618,376,242,455,279,176,14.8,9.0,5.8,10.9,6.7,4.2
08316017,"Herbolzheim, Stadt",08,Baden-Württemberg,10738,5384,5354,1228,719,509,1523,919,604,11.4,6.7,4.7,14.2,8.6,5.6
08316020,"Kenzingen, Stadt",08,Baden-Württemberg,9752,4868,4884,1080,636,444,1068,641,427,11.1,6.5,4.6,11.0,6.6,4.4
08316049,Weisweil,08,Baden-Württemberg,2066,1008,1058,198,104,94,124,63,61,9.6,5.0,4.5,6.0,3.0,3.0
08316053,Rheinhausen,08,Baden-Württemberg,3727,1843,1884,396,222,174,286,164,122,10.6,6.0,4.7,7.7,4.4,3.3
08316002,Bahlingen am Kaiserstuhl,08,Baden-Württemberg,4275,2141,2134,451,283,168,417,229,188,10.5,6.6,3.9,9.8,5.4,4.4
08316012,"Endingen am Kaiserstuhl, Stadt",08,Baden-Württemberg,9225,4568,4657,1046,620,426,1014,620,394,11.3,6.7,4.6,11.0,6.7,4.3
08316013,Forchheim,08,Baden-Württemberg,1442,732,710,164,89,75,101,46,55,11.4,6.2,5.2,7.0,3.2,3.8
08316037,Riegel am Kaiserstuhl,08,Baden-Württemberg,3861,1923,1938,435,266,169,928,731,197,11.3,6.9,4.4,24.0,18.9,5.1
08316038,Sasbach am Kaiserstuhl,08,Baden-Württemberg,3383,1701,1682,411,258,153,286,179,107,12.1,7.6,4.5,8.5,5.3,3.2
08316051,Wyhl am Kaiserstuhl,08,Baden-Württemberg,3686,1849,1837,444,290,154,246,151,95,12.0,7.9,4.2,6.7,4.1,2.6
08316014,Gutach im Breisgau,08,Baden-Württemberg,4344,2159,2185,545,328,217,358,218,140,12.5,7.6,5.0,8.2,5.0,3.2
08316042,Simonswald,08,Baden-Württemberg,3116,1591,1525,369,234,135,222,145,77,11.8,7.5,4.3,7.1,4.7,2.5
08316056,"Waldkirch, Stadt",08,Baden-Württemberg,21561,10465,11096,2323,1380,943,1912,1165,747,10.8,6.4,4.4,8.9,5.4,3.5
08317005,Appenweier,08,Baden-Württemberg,10068,5068,5000,1224,715,509,1089,683,406,12.2,7.1,5.1,10.8,6.8,4.0
08317031,Friesenheim,08,Baden-Württemberg,12921,6384,6537,1342,790,552,1007,624,383,10.4,6.1,4.3,7.8,4.8,3.0
08317051,"Hornberg, Stadt",08,Baden-Württemberg,4320,2149,2171,564,317,247,442,249,193,13.1,7.3,5.7,10.2,5.8,4.5
08317057,"Kehl, Stadt",08,Baden-Württemberg,35032,17312,17720,3966,2395,1571,4105,2562,1543,11.3,6.8,4.5,11.7,7.3,4.4
08317141,Willstätt,08,Baden-Württemberg,9569,4765,4804,1057,579,478,760,419,341,11.0,6.1,5.0,7.9,4.4,3.6
08317151,Neuried,08,Baden-Württemberg,9419,4677,4742,1151,690,461,763,446,317,12.2,7.3,4.9,8.1,4.7,3.4
08317153,"Rheinau, Stadt",08,Baden-Württemberg,11123,5570,5553,1354,859,495,1150,719,431,12.2,7.7,4.5,10.3,6.5,3.9
08317001,"Achern, Stadt",08,Baden-Württemberg,25018,12384,12634,3251,1952,1299,3286,2063,1223,13.0,7.8,5.2,13.1,8.2,4.9
08317068,Lauf,08,Baden-Württemberg,3886,1903,1983,463,301,162,345,182,163,11.9,7.7,4.2,8.9,4.7,4.2
08317116,Sasbach,08,Baden-Württemberg,5382,2611,2771,730,418,312,813,494,319,13.6,7.8,5.8,15.1,9.2,5.9
08317118,Sasbachwalden,08,Baden-Württemberg,2481,1238,1243,296,190,106,395,274,121,11.9,7.7,4.3,15.9,11.0,4.9
08317026,"Ettenheim, Stadt",08,Baden-Württemberg,12837,6201,6636,1354,805,549,1154,696,458,10.5,6.3,4.3,9.0,5.4,3.6
08317073,"Mahlberg, Stadt",08,Baden-Württemberg,4887,2434,2453,551,318,233,376,233,143,11.3,6.5,4.8,7.7,4.8,2.9
08317113,Ringsheim,08,Baden-Württemberg,2281,1156,1125,256,161,95,599,491,108,11.2,7.1,4.2,26.3,21.5,4.7
08317114,Rust,08,Baden-Württemberg,4003,2003,2000,458,241,217,864,397,467,11.4,6.0,5.4,21.6,9.9,11.7
08317152,Kappel-Grafenhausen,08,Baden-Württemberg,4963,2554,2409,527,264,263,345,195,150,10.6,5.3,5.3,7.0,3.9,3.0
08317009,Berghaupten,08,Baden-Württemberg,2415,1203,1212,263,160,103,192,117,75,10.9,6.6,4.3,8.0,4.8,3.1
08317034,"Gengenbach, Stadt",08,Baden-Württemberg,10941,5280,5661,1336,784,552,1225,751,474,12.2,7.2,5.0,11.2,6.9,4.3
08317097,Ohlsbach,08,Baden-Württemberg,3196,1597,1599,328,203,125,191,116,75,10.3,6.4,3.9,6.0,3.6,2.3
08317029,Fischerbach,08,Baden-Württemberg,1739,894,845,270,164,106,234,123,111,15.5,9.4,6.1,13.5,7.1,6.4
08317040,"Haslach im Kinzigtal, Stadt",08,Baden-Württemberg,6934,3428,3506,964,577,387,1207,746,461,13.9,8.3,5.6,17.4,10.8,6.6
08317046,Hofstetten,08,Baden-Württemberg,1710,875,835,286,179,107,155,86,69,16.7,10.5,6.3,9.1,5.0,4.0
08317078,Mühlenbach,08,Baden-Württemberg,1653,870,783,222,133,89,66,45,21,13.4,8.0,5.4,4.0,2.7,1.3
08317129,Steinach,08,Baden-Württemberg,4092,2042,2050,536,344,192,309,183,126,13.1,8.4,4.7,7.6,4.5,3.1
08317039,Gutach (Schwarzwaldbahn),08,Baden-Württemberg,2267,1121,1146,296,176,120,241,150,91,13.1,7.8,5.3,10.6,6.6,4.0
08317041,"Hausach, Stadt",08,Baden-Württemberg,5746,2868,2878,716,403,313,809,473,336,12.5,7.0,5.4,14.1,8.2,5.8
08317056,Kappelrodeck,08,Baden-Württemberg,5865,2941,2924,798,483,315,658,391,267,13.6,8.2,5.4,11.2,6.7,4.6
08317102,Ottenhöfen im Schwarzwald,08,Baden-Württemberg,3161,1577,1584,444,292,152,285,174,111,14.0,9.2,4.8,9.0,5.5,3.5
08317126,Seebach,08,Baden-Württemberg,1382,717,665,226,132,94,171,103,68,16.4,9.6,6.8,12.4,7.5,4.9
08317059,Kippenheim,08,Baden-Württemberg,5352,2702,2650,550,309,241,533,280,253,10.3,5.8,4.5,10.0,5.2,4.7
08317065,"Lahr/Schwarzwald, Stadt",08,Baden-Württemberg,44884,22202,22682,4603,2674,1929,4391,2541,1850,10.3,6.0,4.3,9.8,5.7,4.1
08317008,Bad Peterstal-Griesbach,08,Baden-Württemberg,2745,1404,1341,304,197,107,301,204,97,11.1,7.2,3.9,11.0,7.4,3.5
08317098,"Oppenau, Stadt",08,Baden-Württemberg,4681,2360,2321,590,365,225,490,288,202,12.6,7.8,4.8,10.5,6.2,4.3
08317067,Lautenbach,08,Baden-Württemberg,1832,939,893,224,149,75,120,79,41,12.2,8.1,4.1,6.6,4.3,2.2
08317089,"Oberkirch, Stadt",08,Baden-Württemberg,19833,9850,9983,2397,1503,894,2175,1388,787,12.1,7.6,4.5,11.0,7.0,4.0
08317110,"Renchen, Stadt",08,Baden-Württemberg,7238,3627,3611,978,566,412,874,484,390,13.5,7.8,5.7,12.1,6.7,5.4
08317021,Durbach,08,Baden-Württemberg,3867,1892,1975,490,333,157,446,292,154,12.7,8.6,4.1,11.5,7.6,4.0
08317047,Hohberg,08,Baden-Württemberg,8055,4039,4016,945,573,372,483,271,212,11.7,7.1,4.6,6.0,3.4,2.6
08317096,"Offenburg, Stadt",08,Baden-Württemberg,58465,28514,29951,6551,3872,2679,9603,5630,3973,11.2,6.6,4.6,16.4,9.6,6.8
08317100,Ortenberg,08,Baden-Württemberg,3453,1718,1735,411,227,184,235,128,107,11.9,6.6,5.3,6.8,3.7,3.1
08317122,Schutterwald,08,Baden-Württemberg,7086,3581,3505,824,506,318,789,525,264,11.6,7.1,4.5,11.1,7.4,3.7
08317121,Schuttertal,08,Baden-Württemberg,3135,1588,1547,390,235,155,215,122,93,12.4,7.5,4.9,6.9,3.9,3.0
08317127,Seelbach,08,Baden-Württemberg,4894,2392,2502,528,315,213,397,242,155,10.8,6.4,4.4,8.1,4.9,3.2
08317075,Meißenheim,08,Baden-Württemberg,3902,1929,1973,419,280,139,272,179,93,10.7,7.2,3.6,7.0,4.6,2.4
08317150,Schwanau,08,Baden-Württemberg,6959,3546,3413,730,432,298,501,305,196,10.5,6.2,4.3,7.2,4.4,2.8
08317093,Oberwolfach,08,Baden-Württemberg,2571,1319,1252,333,214,119,299,179,120,13.0,8.3,4.6,11.6,7.0,4.7
08317145,"Wolfach, Stadt",08,Baden-Württemberg,5774,2902,2872,712,396,316,636,371,265,12.3,6.9,5.5,11.0,6.4,4.6
08317011,Biberach,08,Baden-Württemberg,3601,1797,1804,458,275,183,332,202,130,12.7,7.6,5.1,9.2,5.6,3.6
08317085,Nordrach,08,Baden-Württemberg,1919,988,931,215,128,87,147,90,57,11.2,6.7,4.5,7.7,4.7,3.0
08317088,Oberharmersbach,08,Baden-Württemberg,2530,1290,1240,328,206,122,243,143,100,13.0,8.1,4.8,9.6,5.7,4.0
08317146,"Zell am Harmersbach, Stadt",08,Baden-Württemberg,8039,3992,4047,951,596,355,959,634,325,11.8,7.4,4.4,11.9,7.9,4.0
08325012,"Dornhan, Stadt",08,Baden-Württemberg,6028,3029,2999,799,483,316,609,351,258,13.3,8.0,5.2,10.1,5.8,4.3
08325014,Dunningen,08,Baden-Württemberg,6091,3085,3006,714,411,303,605,324,281,11.7,6.7,5.0,9.9,5.3,4.6
08325071,Eschbronn,08,Baden-Württemberg,2065,1014,1051,275,156,119,139,81,58,13.3,7.6,5.8,6.7,3.9,2.8
08325015,Epfendorf,08,Baden-Württemberg,3280,1674,1606,388,233,155,174,100,74,11.8,7.1,4.7,5.3,3.0,2.3
08325045,"Oberndorf am Neckar, Stadt",08,Baden-Württemberg,13803,6844,6959,1628,1001,627,2632,1557,1075,11.8,7.3,4.5,19.1,11.3,7.8
08325070,Fluorn-Winzeln,08,Baden-Württemberg,3077,1580,1497,414,241,173,369,211,158,13.5,7.8,5.6,12.0,6.9,5.1
08325011,Dietingen,08,Baden-Württemberg,3939,1980,1959,475,291,184,424,257,167,12.1,7.4,4.7,10.8,6.5,4.2
08325049,"Rottweil, Stadt",08,Baden-Württemberg,24915,12234,12681,2926,1740,1186,3106,1800,1306,11.7,7.0,4.8,12.5,7.2,5.2
08325064,Wellendingen,08,Baden-Württemberg,3080,1554,1526,337,202,135,269,162,107,10.9,6.6,4.4,8.7,5.3,3.5
08325069,Zimmern ob Rottweil,08,Baden-Württemberg,5987,2965,3022,732,419,313,756,436,320,12.2,7.0,5.2,12.6,7.3,5.3
08325072,Deißlingen,08,Baden-Württemberg,6066,3057,3009,763,432,331,784,405,379,12.6,7.1,5.5,12.9,6.7,6.2
08325050,Schenkenzell,08,Baden-Württemberg,1826,929,897,214,127,87,158,86,72,11.7,7.0,4.8,8.7,4.7,3.9
08325051,"Schiltach, Stadt",08,Baden-Württemberg,3803,1863,1940,465,280,185,405,251,154,12.2,7.4,4.9,10.6,6.6,4.0
08325001,Aichhalden,08,Baden-Württemberg,4053,2033,2020,517,292,225,415,235,180,12.8,7.2,5.6,10.2,5.8,4.4
08325024,Hardt,08,Baden-Württemberg,2529,1285,1244,358,211,147,360,210,150,14.2,8.3,5.8,14.2,8.3,5.9
08325036,Lauterbach,08,Baden-Württemberg,2972,1479,1493,404,263,141,264,153,111,13.6,8.8,4.7,8.9,5.1,3.7
08325053,"Schramberg, Stadt",08,Baden-Württemberg,20985,10483,10502,2367,1361,1006,2320,1334,986,11.3,6.5,4.8,11.1,6.4,4.7
08325057,"Sulz am Neckar, Stadt",08,Baden-Württemberg,12092,5971,6121,1565,957,608,1308,821,487,12.9,7.9,5.0,10.8,6.8,4.0
08325061,Vöhringen,08,Baden-Württemberg,4309,2164,2145,559,323,236,396,217,179,13.0,7.5,5.5,9.2,5.0,4.2
08325009,Bösingen,08,Baden-Württemberg,3350,1693,1657,479,282,197,459,267,192,14.3,8.4,5.9,13.7,8.0,5.7
08325060,Villingendorf,08,Baden-Württemberg,3250,1588,1662,444,249,195,543,318,225,13.7,7.7,6.0,16.7,9.8,6.9
08326003,"Bad Dürrheim, Stadt",08,Baden-Württemberg,12896,6234,6662,1336,792,544,1372,839,533,10.4,6.1,4.2,10.6,6.5,4.1
08326005,"Blumberg, Stadt",08,Baden-Württemberg,9975,5015,4960,1065,632,433,746,453,293,10.7,6.3,4.3,7.5,4.5,2.9
08326031,Königsfeld im Schwarzwald,08,Baden-Württemberg,5945,2866,3079,628,386,242,540,318,222,10.6,6.5,4.1,9.1,5.3,3.7
08326052,"St. Georgen im Schwarzwald, Stadt",08,Baden-Württemberg,12838,6338,6500,1463,791,672,1064,630,434,11.4,6.2,5.2,8.3,4.9,3.4
08326068,"Vöhrenbach, Stadt",08,Baden-Württemberg,3823,1949,1874,428,261,167,262,159,103,11.2,6.8,4.4,6.9,4.2,2.7
08326006,"Bräunlingen, Stadt",08,Baden-Württemberg,5752,2872,2880,737,437,300,663,378,285,12.8,7.6,5.2,11.5,6.6,5.0
08326012,"Donaueschingen, Stadt",08,Baden-Württemberg,21746,10829,10917,2602,1511,1091,3436,1751,1685,12.0,6.9,5.0,15.8,8.1,7.7
08326027,"Hüfingen, Stadt",08,Baden-Württemberg,7583,3778,3805,896,514,382,683,378,305,11.8,6.8,5.0,9.0,5.0,4.0
08326017,"Furtwangen im Schwarzwald, Stadt",08,Baden-Württemberg,9091,4693,4398,1236,757,479,1136,720,416,13.6,8.3,5.3,12.5,7.9,4.6
08326020,Gütenbach,08,Baden-Württemberg,1170,589,581,139,85,54,97,48,49,11.9,7.3,4.6,8.3,4.1,4.2
08326054,Schönwald im Schwarzwald,08,Baden-Württemberg,2380,1202,1178,294,184,110,288,164,124,12.4,7.7,4.6,12.1,6.9,5.2
08326055,Schonach im Schwarzwald,08,Baden-Württemberg,4009,2017,1992,527,327,200,444,271,173,13.1,8.2,5.0,11.1,6.8,4.3
08326060,"Triberg im Schwarzwald, Stadt",08,Baden-Württemberg,4787,2391,2396,651,415,236,618,388,230,13.6,8.7,4.9,12.9,8.1,4.8
08326010,Dauchingen,08,Baden-Württemberg,3649,1805,1844,390,217,173,380,186,194,10.7,5.9,4.7,10.4,5.1,5.3
08326037,Mönchweiler,08,Baden-Württemberg,2960,1469,1491,326,182,144,401,216,185,11.0,6.1,4.9,13.5,7.3,6.2
08326041,Niedereschach,08,Baden-Württemberg,5887,2946,2941,653,371,282,1008,541,467,11.1,6.3,4.8,17.1,9.2,7.9
08326061,Tuningen,08,Baden-Württemberg,2936,1461,1475,350,222,128,341,194,147,11.9,7.6,4.4,11.6,6.6,5.0
08326065,Unterkirnach,08,Baden-Württemberg,2534,1347,1187,315,184,131,253,140,113,12.4,7.3,5.2,10.0,5.5,4.5
08326074,"Villingen-Schwenningen, Stadt",08,Baden-Württemberg,84674,41660,43014,9144,5159,3985,11192,7008,4184,10.8,6.1,4.7,13.2,8.3,4.9
08326075,Brigachtal,08,Baden-Württemberg,5013,2443,2570,640,362,278,369,213,156,12.8,7.2,5.5,7.4,4.2,3.1
08327004,Bärenthal,08,Baden-Württemberg,476,242,234,60,33,27,95,55,40,12.6,6.9,5.7,20.0,11.6,8.4
08327008,Buchheim,08,Baden-Württemberg,673,345,328,112,71,41,105,56,49,16.6,10.5,6.1,15.6,8.3,7.3
08327016,"Fridingen an der Donau, Stadt",08,Baden-Württemberg,3119,1540,1579,367,225,142,265,171,94,11.8,7.2,4.6,8.5,5.5,3.0
08327027,Irndorf,08,Baden-Württemberg,714,351,363,89,59,30,63,43,20,12.5,8.3,4.2,8.8,6.0,2.8
08327030,Kolbingen,08,Baden-Württemberg,1232,601,631,200,121,79,157,91,66,16.2,9.8,6.4,12.7,7.4,5.4
08327036,"Mühlheim an der Donau, Stadt",08,Baden-Württemberg,3577,1768,1809,413,259,154,362,214,148,11.5,7.2,4.3,10.1,6.0,4.1
08327041,Renquishausen,08,Baden-Württemberg,742,388,354,136,76,60,118,62,56,18.3,10.2,8.1,15.9,8.4,7.5
08327007,Bubsheim,08,Baden-Württemberg,1301,708,593,120,68,52,125,61,64,9.2,5.2,4.0,9.6,4.7,4.9
08327009,Deilingen,08,Baden-Württemberg,1722,887,835,219,117,102,326,188,138,12.7,6.8,5.9,18.9,10.9,8.0
08327013,Egesheim,08,Baden-Württemberg,643,329,314,94,57,37,74,49,25,14.6,8.9,5.8,11.5,7.6,3.9
08327019,Gosheim,08,Baden-Württemberg,3876,1920,1956,500,291,209,538,301,237,12.9,7.5,5.4,13.9,7.8,6.1
08327029,Königsheim,08,Baden-Württemberg,550,285,265,86,45,41,130,64,66,15.6,8.2,7.5,23.6,11.6,12.0
08327040,Reichenbach am Heuberg,08,Baden-Württemberg,484,238,246,78,38,40,50,27,23,16.1,7.9,8.3,10.3,5.6,4.8
08327051,Wehingen,08,Baden-Württemberg,3585,1782,1803,481,259,222,393,221,172,13.4,7.2,6.2,11.0,6.2,4.8
08327018,"Geisingen, Stadt",08,Baden-Württemberg,6110,3120,2990,642,388,254,714,415,299,10.5,6.4,4.2,11.7,6.8,4.9
08327025,Immendingen,08,Baden-Württemberg,6247,3201,3046,698,393,305,367,216,151,11.2,6.3,4.9,5.9,3.5,2.4
08327002,Aldingen,08,Baden-Württemberg,7516,3782,3734,807,484,323,621,351,270,10.7,6.4,4.3,8.3,4.7,3.6
08327005,Balgheim,08,Baden-Württemberg,1194,614,580,151,84,67,382,266,116,12.6,7.0,5.6,32.0,22.3,9.7
08327006,Böttingen,08,Baden-Württemberg,1415,711,704,163,92,71,102,61,41,11.5,6.5,5.0,7.2,4.3,2.9
08327010,Denkingen,08,Baden-Württemberg,2591,1302,1289,293,166,127,221,128,93,11.3,6.4,4.9,8.5,4.9,3.6
08327011,Dürbheim,08,Baden-Württemberg,1637,798,839,206,116,90,141,73,68,12.6,7.1,5.5,8.6,4.5,4.2
08327017,Frittlingen,08,Baden-Württemberg,2077,1053,1024,295,170,125,271,154,117,14.2,8.2,6.0,13.0,7.4,5.6
08327023,Hausen ob Verena,08,Baden-Württemberg,751,376,375,86,58,28,59,35,24,11.5,7.7,3.7,7.9,4.7,3.2
08327033,Mahlstetten,08,Baden-Württemberg,791,405,386,101,66,35,84,57,27,12.8,8.3,4.4,10.6,7.2,3.4
08327046,"Spaichingen, Stadt",08,Baden-Württemberg,12637,6226,6411,1403,812,591,1464,881,583,11.1,6.4,4.7,11.6,7.0,4.6
08327012,Durchhausen,08,Baden-Württemberg,927,469,458,112,66,46,73,45,28,12.1,7.1,5.0,7.9,4.9,3.0
08327020,Gunningen,08,Baden-Württemberg,710,356,354,88,58,30,32,20,12,12.4,8.2,4.2,4.5,2.8,1.7
08327048,Talheim,08,Baden-Württemberg,1191,610,581,173,97,76,68,32,36,14.5,8.1,6.4,5.7,2.7,3.0
08327049,"Trossingen, Stadt",08,Baden-Württemberg,16123,8073,8050,1837,1119,718,1433,913,520,11.4,6.9,4.5,8.9,5.7,3.2
08327038,Neuhausen ob Eck,08,Baden-Württemberg,3976,2011,1965,520,280,240,416,244,172,13.1,7.0,6.0,10.5,6.1,4.3
08327050,"Tuttlingen, Stadt",08,Baden-Württemberg,34586,17187,17399,4166,2327,1839,4748,2741,2007,12.0,6.7,5.3,13.7,7.9,5.8
08327054,Wurmlingen,08,Baden-Württemberg,3783,1871,1912,493,285,208,486,256,230,13.0,7.5,5.5,12.8,6.8,6.1
08327055,Seitingen-Oberflacht,08,Baden-Württemberg,2359,1203,1156,314,198,116,236,132,104,13.3,8.4,4.9,10.0,5.6,4.4
08327056,Rietheim-Weilheim,08,Baden-Württemberg,2697,1340,1357,308,173,135,247,130,117,11.4,6.4,5.0,9.2,4.8,4.3
08327057,Emmingen-Liptingen,08,Baden-Württemberg,4594,2295,2299,588,335,253,534,273,261,12.8,7.3,5.5,11.6,5.9,5.7
08335035,Hilzingen,08,Baden-Württemberg,8493,4185,4308,920,600,320,675,432,243,10.8,7.1,3.8,7.9,5.1,2.9
08335063,"Radolfzell am Bodensee, Stadt",08,Baden-Württemberg,30943,15043,15900,3151,2002,1149,3411,2175,1236,10.2,6.5,3.7,11.0,7.0,4.0
08335080,"Tengen, Stadt",08,Baden-Württemberg,4584,2258,2326,458,307,151,327,221,106,10.0,6.7,3.3,7.1,4.8,2.3
08335001,"Aach, Stadt",08,Baden-Württemberg,2243,1160,1083,244,137,107,156,92,64,10.9,6.1,4.8,7.0,4.1,2.9
08335022,"Engen, Stadt",08,Baden-Württemberg,10435,5094,5341,1106,705,401,1045,645,400,10.6,6.8,3.8,10.0,6.2,3.8
08335097,Mühlhausen-Ehingen,08,Baden-Württemberg,3793,1919,1874,411,258,153,492,350,142,10.8,6.8,4.0,13.0,9.2,3.7
08335015,Büsingen am Hochrhein,08,Baden-Württemberg,1358,655,703,47,41,6,58,44,14,3.5,3.0,0.4,4.3,3.2,1.0
08335026,Gailingen am Hochrhein,08,Baden-Württemberg,2906,1418,1488,243,179,64,211,146,65,8.4,6.2,2.2,7.3,5.0,2.2
08335028,Gottmadingen,08,Baden-Württemberg,10357,5042,5315,986,645,341,911,576,335,9.5,6.2,3.3,8.8,5.6,3.2
08335025,Gaienhofen,08,Baden-Württemberg,3394,1671,1723,328,220,108,307,197,110,9.7,6.5,3.2,9.0,5.8,3.2
08335055,Moos,08,Baden-Württemberg,3307,1610,1697,374,223,151,289,178,111,11.3,6.7,4.6,8.7,5.4,3.4
08335061,Öhningen,08,Baden-Württemberg,3634,1773,1861,350,256,94,292,190,102,9.6,7.0,2.6,8.0,5.2,2.8
08335002,Allensbach,08,Baden-Württemberg,7088,3311,3777,760,502,258,616,414,202,10.7,7.1,3.6,8.7,5.8,2.8
08335043,"Konstanz, Universitätsstadt",08,Baden-Württemberg,82859,39730,43129,10162,7154,3008,11376,7858,3518,12.3,8.6,3.6,13.7,9.5,4.2
08335066,Reichenau,08,Baden-Württemberg,5262,2694,2568,668,438,230,635,432,203,12.7,8.3,4.4,12.1,8.2,3.9
08335075,"Singen (Hohentwiel), Stadt",08,Baden-Württemberg,47287,22997,24290,5328,3166,2162,5376,3373,2003,11.3,6.7,4.6,11.4,7.1,4.2
08335077,Steißlingen,08,Baden-Württemberg,4716,2343,2373,531,332,199,460,265,195,11.3,7.0,4.2,9.8,5.6,4.1
08335081,Volkertshausen,08,Baden-Württemberg,3016,1480,1536,321,201,120,242,165,77,10.6,6.7,4.0,8.0,5.5,2.6
08335100,Rielasingen-Worblingen,08,Baden-Württemberg,11807,5761,6046,1291,791,500,937,591,346,10.9,6.7,4.2,7.9,5.0,2.9
08335021,Eigeltingen,08,Baden-Württemberg,3751,1872,1879,478,253,225,426,247,179,12.7,6.7,6.0,11.4,6.6,4.8
08335057,Mühlingen,08,Baden-Württemberg,2319,1162,1157,281,168,113,141,88,53,12.1,7.2,4.9,6.1,3.8,2.3
08335079,"Stockach, Stadt",08,Baden-Württemberg,16677,8278,8399,1946,1149,797,2906,1841,1065,11.7,6.9,4.8,17.4,11.0,6.4
08335096,Hohenfels,08,Baden-Württemberg,2059,1037,1022,203,122,81,181,103,78,9.9,5.9,3.9,8.8,5.0,3.8
08335098,Bodman-Ludwigshafen,08,Baden-Württemberg,4642,2267,2375,490,313,177,535,322,213,10.6,6.7,3.8,11.5,6.9,4.6
08335099,Orsingen-Nenzingen,08,Baden-Württemberg,3358,1661,1697,376,214,162,364,199,165,11.2,6.4,4.8,10.8,5.9,4.9
08336014,Efringen-Kirchen,08,Baden-Württemberg,8772,4373,4399,868,586,282,648,415,233,9.9,6.7,3.2,7.4,4.7,2.7
08336084,Steinen,08,Baden-Württemberg,9900,4832,5068,1024,690,334,977,658,319,10.3,7.0,3.4,9.9,6.6,3.2
08336087,"Todtnau, Stadt",08,Baden-Württemberg,4904,2425,2479,583,322,261,565,317,248,11.9,6.6,5.3,11.5,6.5,5.1
08336091,"Weil am Rhein, Stadt",08,Baden-Württemberg,30030,14533,15497,3078,2039,1039,2748,1837,911,10.2,6.8,3.5,9.2,6.1,3.0
08336105,Grenzach-Wyhlen,08,Baden-Württemberg,14171,6887,7284,1104,766,338,807,556,251,7.8,5.4,2.4,5.7,3.9,1.8
08336107,Kleines Wiesental,08,Baden-Württemberg,2932,1501,1431,371,247,124,222,146,76,12.7,8.4,4.2,7.6,5.0,2.6
08336045,"Kandern, Stadt",08,Baden-Württemberg,8209,4005,4204,809,533,276,712,451,261,9.9,6.5,3.4,8.7,5.5,3.2
08336104,Malsburg-Marzell,08,Baden-Württemberg,1455,754,701,148,104,44,66,48,18,10.2,7.1,3.0,4.5,3.3,1.2
08336043,Inzlingen,08,Baden-Württemberg,2455,1202,1253,203,151,52,132,84,48,8.3,6.2,2.1,5.4,3.4,2.0
08336050,"Lörrach, Stadt",08,Baden-Württemberg,49303,23809,25494,4636,2935,1701,6598,4349,2249,9.4,6.0,3.5,13.4,8.8,4.6
08336069,"Rheinfelden (Baden), Stadt",08,Baden-Württemberg,32756,16092,16664,2961,1975,986,3393,2203,1190,9.0,6.0,3.0,10.4,6.7,3.6
08336082,Schwörstadt,08,Baden-Württemberg,2399,1185,1214,243,157,86,142,90,52,10.1,6.5,3.6,5.9,3.8,2.2
08336006,Bad Bellingen,08,Baden-Württemberg,4218,2100,2118,451,290,161,479,303,176,10.7,6.9,3.8,11.4,7.2,4.2
08336078,Schliengen,08,Baden-Württemberg,5448,2661,2787,599,358,241,468,285,183,11.0,6.6,4.4,8.6,5.2,3.4
08336004,Aitern,08,Baden-Württemberg,553,289,264,69,49,20,23,17,6,12.5,8.9,3.6,4.2,3.1,1.1
08336010,Böllen,08,Baden-Württemberg,96,50,46,9,5,4,-1,-1,-1,9.4,5.2,4.2,-1.0,,
08336025,Fröhnd,08,Baden-Württemberg,472,238,234,78,53,25,21,17,4,16.5,11.2,5.3,4.4,3.6,0.8
08336079,"Schönau im Schwarzwald, Stadt",08,Baden-Württemberg,2405,1199,1206,299,171,128,337,210,127,12.4,7.1,5.3,14.0,8.7,5.3
08336080,Schönenberg,08,Baden-Württemberg,352,181,171,81,50,31,-1,-1,-1,23.0,14.2,8.8,-0.3,,
08336089,Tunau,08,Baden-Württemberg,182,96,86,18,12,6,-1,-1,-1,9.9,6.6,3.3,-0.5,,
08336090,Utzenfeld,08,Baden-Württemberg,626,314,312,72,34,38,66,44,22,11.5,5.4,6.1,10.5,7.0,3.5
08336094,Wembach,08,Baden-Württemberg,339,171,168,38,26,12,-1,-1,-1,11.2,7.7,3.5,-0.3,,
08336096,Wieden,08,Baden-Württemberg,585,304,281,73,49,24,35,20,15,12.5,8.4,4.1,6.0,3.4,2.6
08336034,Hasel,08,Baden-Württemberg,1130,572,558,103,76,27,53,31,22,9.1,6.7,2.4,4.7,2.7,1.9
08336036,Hausen im Wiesental,08,Baden-Württemberg,2361,1151,1210,245,160,85,122,72,50,10.4,6.8,3.6,5.2,3.0,2.1
08336057,Maulburg,08,Baden-Württemberg,4330,2195,2135,466,283,183,397,243,154,10.8,6.5,4.2,9.2,5.6,3.6
08336081,"Schopfheim, Stadt",08,Baden-Württemberg,19498,9495,10003,2003,1262,741,1850,1182,668,10.3,6.5,3.8,9.5,6.1,3.4
08336008,Binzen,08,Baden-Württemberg,2985,1457,1528,243,163,80,374,270,104,8.1,5.5,2.7,12.5,9.0,3.5
08336019,Eimeldingen,08,Baden-Württemberg,2516,1237,1279,240,159,81,390,290,100,9.5,6.3,3.2,15.5,11.5,4.0
08336024,Fischingen,08,Baden-Württemberg,746,377,369,74,52,22,119,92,27,9.9,7.0,2.9,16.0,12.3,3.6
08336073,Rümmingen,08,Baden-Württemberg,1762,884,878,160,100,60,83,55,28,9.1,5.7,3.4,4.7,3.1,1.6
08336075,Schallbach,08,Baden-Württemberg,768,373,395,63,39,24,31,11,20,8.2,5.1,3.1,4.0,1.4,2.6
08336100,Wittlingen,08,Baden-Württemberg,978,477,501,113,73,40,39,29,10,11.6,7.5,4.1,4.0,3.0,1.0
08336103,"Zell im Wiesental, Stadt",08,Baden-Württemberg,6208,3078,3130,674,398,276,449,230,219,10.9,6.4,4.4,7.2,3.7,3.5
08336106,Häg-Ehrsberg,08,Baden-Württemberg,864,438,426,95,58,37,59,37,22,11.0,6.7,4.3,6.8,4.3,2.5
08337002,Albbruck,08,Baden-Württemberg,7296,3710,3586,806,547,259,663,434,229,11.0,7.5,3.5,9.1,5.9,3.1
08337038,Görwihl,08,Baden-Württemberg,4275,2124,2151,486,350,136,441,314,127,11.4,8.2,3.2,10.3,7.3,3.0
08337062,Klettgau,08,Baden-Württemberg,7414,3681,3733,793,570,223,620,451,169,10.7,7.7,3.0,8.4,6.1,2.3
08337066,"Laufenburg (Baden), Stadt",08,Baden-Württemberg,8856,4329,4527,893,590,303,860,548,312,10.1,6.7,3.4,9.7,6.2,3.5
08337106,"Stühlingen, Stadt",08,Baden-Württemberg,5063,2536,2527,550,364,186,569,380,189,10.9,7.2,3.7,11.2,7.5,3.7
08337116,"Wehr, Stadt",08,Baden-Württemberg,12718,6125,6593,1362,897,465,907,606,301,10.7,7.1,3.7,7.1,4.8,2.4
08337022,"Bonndorf im Schwarzwald, Stadt",08,Baden-Württemberg,6836,3472,3364,707,459,248,644,446,198,10.3,6.7,3.6,9.4,6.5,2.9
08337127,Wutach,08,Baden-Württemberg,1193,590,603,139,101,38,72,43,29,11.7,8.5,3.2,6.0,3.6,2.4
08337030,Dettighofen,08,Baden-Württemberg,1113,564,549,111,88,23,87,75,12,10.0,7.9,2.1,7.8,6.7,1.1
08337060,Jestetten,08,Baden-Württemberg,5130,2485,2645,473,335,138,500,365,135,9.2,6.5,2.7,9.7,7.1,2.6
08337070,Lottstetten,08,Baden-Württemberg,2254,1137,1117,192,144,48,180,132,48,8.5,6.4,2.1,8.0,5.9,2.1
08337053,Hohentengen am Hochrhein,08,Baden-Württemberg,3720,1918,1802,302,210,92,320,243,77,8.1,5.6,2.5,8.6,6.5,2.1
08337125,Küssaberg,08,Baden-Württemberg,5321,2614,2707,463,327,136,395,270,125,8.7,6.1,2.6,7.4,5.1,2.3
08337039,Grafenhausen,08,Baden-Württemberg,2246,1131,1115,308,206,102,286,194,92,13.7,9.2,4.5,12.7,8.6,4.1
08337128,Ühlingen-Birkendorf,08,Baden-Württemberg,5181,2604,2577,592,412,180,344,241,103,11.4,8.0,3.5,6.6,4.7,2.0
08337049,Herrischried,08,Baden-Württemberg,2777,1412,1365,247,175,72,178,120,58,8.9,6.3,2.6,6.4,4.3,2.1
08337076,Murg,08,Baden-Württemberg,6917,3444,3473,679,430,249,631,379,252,9.8,6.2,3.6,9.1,5.5,3.6
08337090,Rickenbach,08,Baden-Württemberg,3987,2019,1968,378,252,126,297,204,93,9.5,6.3,3.2,7.4,5.1,2.3
08337096,"Bad Säckingen, Stadt",08,Baden-Württemberg,17036,8277,8759,1553,989,564,2048,1344,704,9.1,5.8,3.3,12.0,7.9,4.1
08337013,Bernau im Schwarzwald,08,Baden-Württemberg,1976,1006,970,267,168,99,304,183,121,13.5,8.5,5.0,15.4,9.3,6.1
08337027,Dachsberg (Südschwarzwald),08,Baden-Württemberg,1333,650,683,146,100,46,72,50,22,11.0,7.5,3.5,5.4,3.8,1.7
08337045,Häusern,08,Baden-Württemberg,1308,643,665,160,97,63,129,84,45,12.2,7.4,4.8,9.9,6.4,3.4
08337051,Höchenschwand,08,Baden-Württemberg,2548,1266,1282,287,171,116,303,184,119,11.3,6.7,4.6,11.9,7.2,4.7
08337059,Ibach,08,Baden-Württemberg,363,172,191,40,25,15,17,10,7,11.0,6.9,4.1,4.7,2.8,1.9
08337097,"St. Blasien, Stadt",08,Baden-Württemberg,4016,1949,2067,449,267,182,433,276,157,11.2,6.6,4.5,10.8,6.9,3.9
08337108,Todtmoos,08,Baden-Württemberg,1910,941,969,239,134,105,192,105,87,12.5,7.0,5.5,10.1,5.5,4.6
08337032,Dogern,08,Baden-Württemberg,2369,1170,1199,262,170,92,301,198,103,11.1,7.2,3.9,12.7,8.4,4.3
08337065,Lauchringen,08,Baden-Württemberg,7630,3758,3872,819,550,269,758,496,262,10.7,7.2,3.5,9.9,6.5,3.4
08337118,Weilheim,08,Baden-Württemberg,3110,1570,1540,335,236,99,147,103,44,10.8,7.6,3.2,4.7,3.3,1.4
08337126,"Waldshut-Tiengen, Stadt",08,Baden-Württemberg,23674,11723,11951,2481,1654,827,3363,2243,1120,10.5,7.0,3.5,14.2,9.5,4.7
08337123,Wutöschingen,08,Baden-Württemberg,6598,3250,3348,760,491,269,563,389,174,11.5,7.4,4.1,8.5,5.9,2.6
08337124,Eggingen,08,Baden-Württemberg,1693,836,857,183,126,57,107,77,30,10.8,7.4,3.4,6.3,4.5,1.8
08415014,Dettingen an der Erms,08,Baden-Württemberg,9477,4699,4778,1072,632,440,958,545,413,11.3,6.7,4.6,10.1,5.8,4.4
08415019,Eningen unter Achalm,08,Baden-Württemberg,10951,5439,5512,1202,691,511,1066,595,471,11.0,6.3,4.7,9.7,5.4,4.3
08415059,"Pfullingen, Stadt",08,Baden-Württemberg,18112,8761,9351,2025,1203,822,1965,1172,793,11.2,6.6,4.5,10.8,6.5,4.4
08415061,"Reutlingen, Stadt",08,Baden-Württemberg,114310,56398,57912,11350,6635,4715,13318,7936,5382,9.9,5.8,4.1,11.7,6.9,4.7
08415073,"Trochtelfingen, Stadt",08,Baden-Württemberg,6371,3208,3163,748,412,336,560,284,276,11.7,6.5,5.3,8.8,4.5,4.3
08415080,Wannweil,08,Baden-Württemberg,5226,2564,2662,502,293,209,292,166,126,9.6,5.6,4.0,5.6,3.2,2.4
08415091,Sonnenbühl,08,Baden-Württemberg,7067,3588,3479,864,547,317,782,483,299,12.2,7.7,4.5,11.1,6.8,4.2
08415092,Lichtenstein,08,Baden-Württemberg,9166,4580,4586,973,581,392,628,379,249,10.6,6.3,4.3,6.9,4.1,2.7
08415093,St. Johann,08,Baden-Württemberg,5034,2554,2480,525,317,208,423,252,171,10.4,6.3,4.1,8.4,5.0,3.4
08415089,Engstingen,08,Baden-Württemberg,5213,2554,2659,661,379,282,811,421,390,12.7,7.3,5.4,15.6,8.1,7.5
08415090,Hohenstein,08,Baden-Württemberg,3646,1817,1829,502,274,228,257,136,121,13.8,7.5,6.3,7.0,3.7,3.3
08415029,Grafenberg,08,Baden-Württemberg,2604,1298,1306,315,171,144,249,129,120,12.1,6.6,5.5,9.6,5.0,4.6
08415050,"Metzingen, Stadt",08,Baden-Württemberg,21612,10552,11060,2499,1435,1064,3119,1876,1243,11.6,6.6,4.9,14.4,8.7,5.8
08415062,Riederich,08,Baden-Württemberg,4376,2175,2201,521,310,211,465,277,188,11.9,7.1,4.8,10.6,6.3,4.3
08415027,Gomadingen,08,Baden-Württemberg,2288,1208,1080,279,159,120,253,161,92,12.2,6.9,5.2,11.1,7.0,4.0
08415048,Mehrstetten,08,Baden-Württemberg,1340,683,657,143,77,66,93,58,35,10.7,5.7,4.9,6.9,4.3,2.6
08415053,"Münsingen, Stadt",08,Baden-Württemberg,14399,7201,7198,1750,964,786,1815,1023,792,12.2,6.7,5.5,12.6,7.1,5.5
08415060,Pliezhausen,08,Baden-Württemberg,9411,4605,4806,1008,611,397,968,625,343,10.7,6.5,4.2,10.3,6.6,3.6
08415087,Walddorfhäslach,08,Baden-Württemberg,4975,2472,2503,518,307,211,346,209,137,10.4,6.2,4.2,7.0,4.2,2.8
08415028,Grabenstetten,08,Baden-Württemberg,1667,839,828,207,117,90,182,98,84,12.4,7.0,5.4,10.9,5.9,5.0
08415039,Hülben,08,Baden-Württemberg,2863,1408,1455,341,204,137,174,99,75,11.9,7.1,4.8,6.1,3.5,2.6
08415078,"Bad Urach, Stadt",08,Baden-Württemberg,12143,5980,6163,1510,834,676,1355,737,618,12.4,6.9,5.6,11.2,6.1,5.1
08415088,Römerstein,08,Baden-Württemberg,3984,1988,1996,578,321,257,477,257,220,14.5,8.1,6.5,12.0,6.5,5.5
08415034,"Hayingen, Stadt",08,Baden-Württemberg,2206,1137,1069,300,198,102,325,220,105,13.6,9.0,4.6,14.7,10.0,4.8
08415058,Pfronstetten,08,Baden-Württemberg,1485,787,698,225,118,107,120,66,54,15.2,7.9,7.2,8.1,4.4,3.6
08415085,Zwiefalten,08,Baden-Württemberg,2187,1139,1048,275,167,108,285,165,120,12.6,7.6,4.9,13.0,7.5,5.5
08416009,Dettenhausen,08,Baden-Württemberg,5518,2699,2819,508,297,211,288,166,122,9.2,5.4,3.8,5.2,3.0,2.2
08416022,Kirchentellinsfurt,08,Baden-Württemberg,5608,2790,2818,559,337,222,513,319,194,10.0,6.0,4.0,9.1,5.7,3.5
08416023,Kusterdingen,08,Baden-Württemberg,8471,4211,4260,847,512,335,525,296,229,10.0,6.0,4.0,6.2,3.5,2.7
08416041,"Tübingen, Universitätsstadt",08,Baden-Württemberg,87464,41686,45778,9824,7092,2732,11640,8176,3464,11.2,8.1,3.1,13.3,9.3,4.0
08416048,Ammerbuch,08,Baden-Württemberg,11264,5597,5667,1142,667,475,804,444,360,10.1,5.9,4.2,7.1,3.9,3.2
08416011,Dußlingen,08,Baden-Württemberg,5819,2855,2964,675,394,281,288,164,124,11.6,6.8,4.8,4.9,2.8,2.1
08416015,Gomaringen,08,Baden-Württemberg,8833,4358,4475,930,522,408,773,448,325,10.5,5.9,4.6,8.8,5.1,3.7
08416026,Nehren,08,Baden-Württemberg,4244,2081,2163,448,272,176,299,161,138,10.6,6.4,4.1,7.0,3.8,3.3
08416006,Bodelshausen,08,Baden-Württemberg,5767,2888,2879,567,342,225,408,231,177,9.8,5.9,3.9,7.1,4.0,3.1
08416025,"Mössingen, Stadt",08,Baden-Württemberg,19874,9638,10236,2280,1395,885,2315,1479,836,11.5,7.0,4.5,11.6,7.4,4.2
08416031,Ofterdingen,08,Baden-Württemberg,4838,2408,2430,526,313,213,492,312,180,10.9,6.5,4.4,10.2,6.4,3.7
08416018,Hirrlingen,08,Baden-Württemberg,3045,1548,1497,297,178,119,187,98,89,9.8,5.8,3.9,6.1,3.2,2.9
08416036,"Rottenburg am Neckar, Stadt",08,Baden-Württemberg,43278,21627,21651,4752,2839,1913,3736,2238,1498,11.0,6.6,4.4,8.6,5.2,3.5
08416049,Neustetten,08,Baden-Württemberg,3539,1759,1780,394,227,167,220,136,84,11.1,6.4,4.7,6.2,3.8,2.4
08416050,Starzach,08,Baden-Württemberg,4275,2123,2152,453,291,162,239,141,98,10.6,6.8,3.8,5.6,3.3,2.3
08417013,"Burladingen, Stadt",08,Baden-Württemberg,12157,5968,6189,1357,772,585,943,508,435,11.2,6.4,4.8,7.8,4.2,3.6
08417025,"Haigerloch, Stadt",08,Baden-Württemberg,10488,5237,5251,1244,724,520,927,552,375,11.9,6.9,5.0,8.8,5.3,3.6
08417054,"Rosenfeld, Stadt",08,Baden-Württemberg,6433,3231,3202,768,454,314,591,347,244,11.9,7.1,4.9,9.2,5.4,3.8
08417010,Bitz,08,Baden-Württemberg,3624,1753,1871,362,196,166,202,127,75,10.0,5.4,4.6,5.6,3.5,2.1
08417079,"Albstadt, Stadt",08,Baden-Württemberg,44431,21823,22608,4819,2835,1984,4867,2850,2017,10.8,6.4,4.5,11.0,6.4,4.5
08417002,"Balingen, Stadt",08,Baden-Württemberg,33640,16355,17285,3812,2172,1640,4975,2740,2235,11.3,6.5,4.9,14.8,8.1,6.6
08417022,"Geislingen, Stadt",08,Baden-Württemberg,5910,2975,2935,700,427,273,463,279,184,11.8,7.2,4.6,7.8,4.7,3.1
08417008,Bisingen,08,Baden-Württemberg,9304,4568,4736,1047,603,444,1148,683,465,11.3,6.5,4.8,12.3,7.3,5.0
08417023,Grosselfingen,08,Baden-Württemberg,2161,1084,1077,219,125,94,140,61,79,10.1,5.8,4.3,6.5,2.8,3.7
08417031,"Hechingen, Stadt",08,Baden-Württemberg,18971,9385,9586,2201,1184,1017,2103,1129,974,11.6,6.2,5.4,11.1,6.0,5.1
08417036,Jungingen,08,Baden-Württemberg,1349,658,691,130,88,42,108,73,35,9.6,6.5,3.1,8.0,5.4,2.6
08417051,Rangendingen,08,Baden-Württemberg,5168,2532,2636,562,329,233,392,210,182,10.9,6.4,4.5,7.6,4.1,3.5
08417044,"Meßstetten, Stadt",08,Baden-Württemberg,12665,6843,5822,1172,715,457,864,545,319,9.3,5.6,3.6,6.8,4.3,2.5
08417045,Nusplingen,08,Baden-Württemberg,1750,878,872,191,130,61,114,62,52,10.9,7.4,3.5,6.5,3.5,3.0
08417047,Obernheim,08,Baden-Württemberg,1413,715,698,150,97,53,99,59,40,10.6,6.9,3.8,7.0,4.2,2.8
08417014,Dautmergen,08,Baden-Württemberg,400,198,202,63,43,20,56,36,20,15.8,10.8,5.0,14.0,9.0,5.0
08417015,Dormettingen,08,Baden-Württemberg,1069,529,540,142,75,67,122,55,67,13.3,7.0,6.3,11.4,5.1,6.3
08417016,Dotternhausen,08,Baden-Württemberg,1835,925,910,220,128,92,221,115,106,12.0,7.0,5.0,12.0,6.3,5.8
08417029,Hausen am Tann,08,Baden-Württemberg,480,245,235,47,33,14,14,11,3,9.8,6.9,2.9,2.9,2.3,0.6
08417052,Ratshausen,08,Baden-Württemberg,758,375,383,109,73,36,123,60,63,14.4,9.6,4.7,16.2,7.9,8.3
08417057,"Schömberg, Stadt",08,Baden-Württemberg,4647,2389,2258,589,329,260,551,318,233,12.7,7.1,5.6,11.9,6.8,5.0
08417071,Weilen unter den Rinnen,08,Baden-Württemberg,603,310,293,68,40,28,37,16,21,11.3,6.6,4.6,6.1,2.7,3.5
08417078,Zimmern unter der Burg,08,Baden-Württemberg,475,249,226,60,30,30,26,10,16,12.6,6.3,6.3,5.5,2.1,3.4
08417063,Straßberg,08,Baden-Württemberg,2478,1236,1242,286,153,133,197,105,92,11.5,6.2,5.4,7.9,4.2,3.7
08417075,Winterlingen,08,Baden-Württemberg,6386,3147,3239,681,412,269,429,275,154,10.7,6.5,4.2,6.7,4.3,2.4
08421000,"Ulm, Universitätsstadt",08,Baden-Württemberg,122636,60400,62236,14175,8542,5633,22051,13029,9022,11.6,7.0,4.6,18.0,10.6,7.4
08425039,"Erbach, Stadt",08,Baden-Württemberg,13387,6756,6631,1586,891,695,1228,698,530,11.8,6.7,5.2,9.2,5.2,4.0
08425108,"Schelklingen, Stadt",08,Baden-Württemberg,6783,3428,3355,769,438,331,496,298,198,11.3,6.5,4.9,7.3,4.4,2.9
08425141,"Blaustein, Stadt",08,Baden-Württemberg,15643,7787,7856,1804,1027,777,1212,648,564,11.5,6.6,5.0,7.7,4.1,3.6
08425002,Allmendingen,08,Baden-Württemberg,4390,2178,2212,545,336,209,361,212,149,12.4,7.7,4.8,8.2,4.8,3.4
08425004,Altheim,08,Baden-Württemberg,599,317,282,76,49,27,32,20,12,12.7,8.2,4.5,5.3,3.3,2.0
08425017,Berghülen,08,Baden-Württemberg,1900,955,945,226,131,95,133,86,47,11.9,6.9,5.0,7.0,4.5,2.5
08425020,"Blaubeuren, Stadt",08,Baden-Württemberg,12087,6077,6010,1334,759,575,1015,637,378,11.0,6.3,4.8,8.4,5.3,3.1
08425028,"Dietenheim, Stadt",08,Baden-Württemberg,6703,3330,3373,798,479,319,559,373,186,11.9,7.1,4.8,8.3,5.6,2.8
08425066,Illerrieden,08,Baden-Württemberg,3309,1674,1635,322,199,123,161,93,68,9.7,6.0,3.7,4.9,2.8,2.1
08425140,Balzheim,08,Baden-Württemberg,2026,1046,980,242,152,90,167,113,54,11.9,7.5,4.4,8.2,5.6,2.7
08425014,Beimerstetten,08,Baden-Württemberg,2616,1338,1278,281,161,120,164,94,70,10.7,6.2,4.6,6.3,3.6,2.7
08425031,Dornstadt,08,Baden-Württemberg,8996,4618,4378,947,555,392,792,458,334,10.5,6.2,4.4,8.8,5.1,3.7
08425135,Westerstetten,08,Baden-Württemberg,2167,1065,1102,248,145,103,130,76,54,11.4,6.7,4.8,6.0,3.5,2.5
08425033,"Ehingen (Donau), Stadt",08,Baden-Württemberg,25503,12862,12641,3240,1824,1416,3399,2026,1373,12.7,7.2,5.6,13.3,7.9,5.4
08425050,Griesingen,08,Baden-Württemberg,1021,524,497,104,63,41,28,14,14,10.2,6.2,4.0,2.7,1.4,1.4
08425088,Oberdischingen,08,Baden-Württemberg,2048,1009,1039,214,127,87,173,102,71,10.4,6.2,4.2,8.4,5.0,3.5
08425093,Öpfingen,08,Baden-Württemberg,2306,1160,1146,283,176,107,148,91,57,12.3,7.6,4.6,6.4,3.9,2.5
08425064,Hüttisheim,08,Baden-Württemberg,1396,684,712,181,111,70,83,51,32,13.0,8.0,5.0,5.9,3.7,2.3
08425110,Schnürpflingen,08,Baden-Württemberg,1343,673,670,179,107,72,131,69,62,13.3,8.0,5.4,9.8,5.1,4.6
08425137,Illerkirchberg,08,Baden-Württemberg,4785,2387,2398,528,302,226,661,268,393,11.0,6.3,4.7,13.8,5.6,8.2
08425138,Staig,08,Baden-Württemberg,3159,1594,1565,323,196,127,250,169,81,10.2,6.2,4.0,7.9,5.3,2.6
08425071,"Laichingen, Stadt",08,Baden-Württemberg,11175,5676,5499,1421,852,569,1293,784,509,12.7,7.6,5.1,11.6,7.0,4.6
08425079,Merklingen,08,Baden-Württemberg,1954,980,974,229,146,83,307,171,136,11.7,7.5,4.2,15.7,8.8,7.0
08425084,Nellingen,08,Baden-Württemberg,1933,992,941,254,164,90,255,148,107,13.1,8.5,4.7,13.2,7.7,5.5
08425134,Westerheim,08,Baden-Württemberg,2936,1483,1453,372,222,150,306,185,121,12.7,7.6,5.1,10.4,6.3,4.1
08425139,Heroldstatt,08,Baden-Württemberg,2790,1381,1409,355,201,154,332,196,136,12.7,7.2,5.5,11.9,7.0,4.9
08425005,Altheim (Alb),08,Baden-Württemberg,1709,873,836,212,128,84,111,57,54,12.4,7.5,4.9,6.5,3.3,3.2
08425011,Asselfingen,08,Baden-Württemberg,1004,522,482,123,68,55,44,22,22,12.3,6.8,5.5,4.4,2.2,2.2
08425013,Ballendorf,08,Baden-Württemberg,671,319,352,89,48,41,45,26,19,13.3,7.2,6.1,6.7,3.9,2.8
08425019,Bernstadt,08,Baden-Württemberg,2153,1121,1032,231,138,93,129,78,51,10.7,6.4,4.3,6.0,3.6,2.4
08425022,Börslingen,08,Baden-Württemberg,171,86,85,29,11,18,-1,-1,-1,17.0,6.4,10.5,-0.6,,
08425024,Breitingen,08,Baden-Württemberg,292,141,151,29,15,14,25,12,13,9.9,5.1,4.8,8.6,4.1,4.5
08425062,Holzkirch,08,Baden-Württemberg,260,126,134,34,19,15,14,8,6,13.1,7.3,5.8,5.4,3.1,2.3
08425072,"Langenau, Stadt",08,Baden-Württemberg,14771,7423,7348,1667,1023,644,1545,961,584,11.3,6.9,4.4,10.5,6.5,4.0
08425083,Neenstetten,08,Baden-Württemberg,826,421,405,120,80,40,97,44,53,14.5,9.7,4.8,11.7,5.3,6.4
08425085,Nerenstetten,08,Baden-Württemberg,329,163,166,49,31,18,9,5,4,14.9,9.4,5.5,2.7,1.5,1.2
08425092,Öllingen,08,Baden-Württemberg,527,263,264,71,40,31,38,24,14,13.5,7.6,5.9,7.2,4.6,2.7
08425097,Rammingen,08,Baden-Württemberg,1272,654,618,159,96,63,169,102,67,12.5,7.5,5.0,13.3,8.0,5.3
08425112,Setzingen,08,Baden-Württemberg,653,336,317,82,53,29,-1,-1,-1,12.6,8.1,4.4,-0.2,,
08425130,Weidenstetten,08,Baden-Württemberg,1345,677,668,158,89,69,76,46,30,11.7,6.6,5.1,5.7,3.4,2.2
08425008,Amstetten,08,Baden-Württemberg,3978,2021,1957,466,283,183,362,206,156,11.7,7.1,4.6,9.1,5.2,3.9
08425075,Lonsee,08,Baden-Württemberg,4894,2484,2410,474,275,199,264,151,113,9.7,5.6,4.1,5.4,3.1,2.3
08425035,Emeringen,08,Baden-Württemberg,128,64,64,37,22,15,-1,-1,-1,28.9,17.2,11.7,-0.8,,
08425036,Emerkingen,08,Baden-Württemberg,822,416,406,106,60,46,90,46,44,12.9,7.3,5.6,10.9,5.6,5.4
08425052,Grundsheim,08,Baden-Württemberg,218,100,118,40,32,8,28,14,14,18.3,14.7,3.7,12.8,6.4,6.4
08425055,Hausen am Bussen,08,Baden-Württemberg,252,128,124,35,24,11,-1,-1,-1,13.9,9.5,4.4,-0.4,,
08425073,Lauterach,08,Baden-Württemberg,609,319,290,75,41,34,-1,-1,-1,12.3,6.7,5.6,-0.2,,
08425081,"Munderkingen, Stadt",08,Baden-Württemberg,5119,2517,2602,544,320,224,416,255,161,10.6,6.3,4.4,8.1,5.0,3.1
08425090,Obermarchtal,08,Baden-Württemberg,1291,661,630,153,104,49,144,76,68,11.9,8.1,3.8,11.2,5.9,5.3
08425091,Oberstadion,08,Baden-Württemberg,1576,831,745,213,121,92,163,94,69,13.5,7.7,5.8,10.3,6.0,4.4
08425098,Rechtenstein,08,Baden-Württemberg,294,148,146,49,27,22,22,11,11,16.7,9.2,7.5,7.5,3.7,3.7
08425104,Rottenacker,08,Baden-Württemberg,2143,1128,1015,254,149,105,283,126,157,11.9,7.0,4.9,13.2,5.9,7.3
08425123,Untermarchtal,08,Baden-Württemberg,879,334,545,80,47,33,65,40,25,9.1,5.3,3.8,7.4,4.6,2.8
08425124,Unterstadion,08,Baden-Württemberg,758,378,380,127,69,58,48,34,14,16.8,9.1,7.7,6.3,4.5,1.8
08425125,Unterwachingen,08,Baden-Württemberg,205,105,100,33,19,14,-1,-1,-1,16.1,9.3,6.8,-0.5,,
08426134,Schemmerhofen,08,Baden-Württemberg,8082,4047,4035,961,596,365,749,400,349,11.9,7.4,4.5,9.3,4.9,4.3
08426005,Alleshausen,08,Baden-Württemberg,498,256,242,68,39,29,-1,-1,-1,13.7,7.8,5.8,-0.2,,
08426006,Allmannsweiler,08,Baden-Württemberg,301,162,139,44,24,20,24,13,11,14.6,8.0,6.6,8.0,4.3,3.7
08426013,"Bad Buchau, Stadt",08,Baden-Württemberg,4033,1983,2050,508,294,214,604,361,243,12.6,7.3,5.3,15.0,9.0,6.0
08426020,Betzenweiler,08,Baden-Württemberg,742,376,366,123,67,56,116,70,46,16.6,9.0,7.5,15.6,9.4,6.2
08426036,Dürnau,08,Baden-Württemberg,416,217,199,68,36,32,37,18,19,16.3,8.7,7.7,8.9,4.3,4.6
08426064,Kanzach,08,Baden-Württemberg,495,241,254,64,34,30,77,37,40,12.9,6.9,6.1,15.6,7.5,8.1
08426078,Moosburg,08,Baden-Württemberg,217,107,110,39,22,17,-1,-1,-1,18.0,10.1,7.8,-0.5,,
08426090,Oggelshausen,08,Baden-Württemberg,921,455,466,151,101,50,60,35,25,16.4,11.0,5.4,6.5,3.8,2.7
08426109,Seekirch,08,Baden-Württemberg,295,154,141,38,26,12,-1,-1,-1,12.9,8.8,4.1,-0.3,,
08426118,Tiefenbach,08,Baden-Württemberg,515,260,255,51,34,17,32,14,18,9.9,6.6,3.3,6.2,2.7,3.5
08426014,"Bad Schussenried, Stadt",08,Baden-Württemberg,8537,4335,4202,1000,595,405,912,552,360,11.7,7.0,4.7,10.7,6.5,4.2
08426062,Ingoldingen,08,Baden-Württemberg,2814,1435,1379,354,208,146,233,125,108,12.6,7.4,5.2,8.3,4.4,3.8
08426011,Attenweiler,08,Baden-Württemberg,1906,1014,892,228,131,97,121,54,67,12.0,6.9,5.1,6.3,2.8,3.5
08426021,"Biberach an der Riß, Stadt",08,Baden-Württemberg,32233,15799,16434,3444,2062,1382,4563,2881,1682,10.7,6.4,4.3,14.2,8.9,5.2
08426038,Eberhardzell,08,Baden-Württemberg,4402,2304,2098,560,326,234,409,233,176,12.7,7.4,5.3,9.3,5.3,4.0
08426058,Hochdorf,08,Baden-Württemberg,2237,1113,1124,283,162,121,748,202,546,12.7,7.2,5.4,33.4,9.0,24.4
08426071,Maselheim,08,Baden-Württemberg,4482,2292,2190,484,286,198,343,185,158,10.8,6.4,4.4,7.7,4.1,3.5
08426074,Mittelbiberach,08,Baden-Württemberg,4330,2151,2179,483,306,177,389,244,145,11.2,7.1,4.1,9.0,5.6,3.3
08426120,Ummendorf,08,Baden-Württemberg,4403,2213,2190,492,307,185,458,279,179,11.2,7.0,4.2,10.4,6.3,4.1
08426128,Warthausen,08,Baden-Württemberg,5242,2592,2650,530,325,205,412,256,156,10.1,6.2,3.9,7.9,4.9,3.0
08426019,Berkheim,08,Baden-Württemberg,2735,1378,1357,377,194,183,439,228,211,13.8,7.1,6.7,16.1,8.3,7.7
08426031,Dettingen an der Iller,08,Baden-Württemberg,2357,1178,1179,307,199,108,286,183,103,13.0,8.4,4.6,12.1,7.8,4.4
08426044,Erolzheim,08,Baden-Württemberg,3287,1646,1641,378,223,155,640,309,331,11.5,6.8,4.7,19.5,9.4,10.1
08426065,Kirchberg an der Iller,08,Baden-Württemberg,2000,1007,993,236,140,96,173,95,78,11.8,7.0,4.8,8.6,4.8,3.9
08426066,Kirchdorf an der Iller,08,Baden-Württemberg,3516,1827,1689,483,289,194,257,154,103,13.7,8.2,5.5,7.3,4.4,2.9
08426001,Achstetten,08,Baden-Württemberg,4501,2276,2225,511,283,228,459,228,231,11.4,6.3,5.1,10.2,5.1,5.1
08426028,Burgrieden,08,Baden-Württemberg,3740,1877,1863,451,263,188,341,163,178,12.1,7.0,5.0,9.1,4.4,4.8
08426070,"Laupheim, Stadt",08,Baden-Württemberg,21153,10525,10628,2515,1437,1078,2697,1626,1071,11.9,6.8,5.1,12.7,7.7,5.1
08426073,Mietingen,08,Baden-Württemberg,4269,2185,2084,510,300,210,309,188,121,11.9,7.0,4.9,7.2,4.4,2.8
08426043,Erlenmoos,08,Baden-Württemberg,1727,881,846,235,149,86,75,40,35,13.6,8.6,5.0,4.3,2.3,2.0
08426087,"Ochsenhausen, Stadt",08,Baden-Württemberg,8812,4480,4332,1079,603,476,1152,689,463,12.2,6.8,5.4,13.1,7.8,5.3
08426113,Steinhausen an der Rottum,08,Baden-Württemberg,2003,1021,982,268,172,96,151,85,66,13.4,8.6,4.8,7.5,4.2,3.3
08426135,Gutenzell-Hürbel,08,Baden-Württemberg,1837,894,943,215,129,86,92,56,36,11.7,7.0,4.7,5.0,3.0,2.0
08426008,Altheim,08,Baden-Württemberg,2147,1079,1068,244,173,71,157,98,59,11.4,8.1,3.3,7.3,4.6,2.7
08426035,Dürmentingen,08,Baden-Württemberg,2619,1319,1300,325,209,116,275,180,95,12.4,8.0,4.4,10.5,6.9,3.6
08426045,Ertingen,08,Baden-Württemberg,5361,2714,2647,663,390,273,605,382,223,12.4,7.3,5.1,11.3,7.1,4.2
08426067,Langenenslingen,08,Baden-Württemberg,3464,1775,1689,434,270,164,378,234,144,12.5,7.8,4.7,10.9,6.8,4.2
08426097,"Riedlingen, Stadt",08,Baden-Württemberg,10451,5231,5220,1137,680,457,1230,784,446,10.9,6.5,4.4,11.8,7.5,4.3
08426121,Unlingen,08,Baden-Württemberg,2409,1213,1196,328,214,114,198,112,86,13.6,8.9,4.7,8.2,4.6,3.6
08426124,Uttenweiler,08,Baden-Württemberg,3489,1768,1721,472,288,184,405,256,149,13.5,8.3,5.3,11.6,7.3,4.3
08426100,Rot an der Rot,08,Baden-Württemberg,4467,2323,2144,555,345,210,509,270,239,12.4,7.7,4.7,11.4,6.0,5.4
08426117,Tannheim,08,Baden-Württemberg,2442,1225,1217,277,165,112,165,101,64,11.3,6.8,4.6,6.8,4.1,2.6
08426108,Schwendi,08,Baden-Württemberg,6520,3363,3157,778,473,305,561,350,211,11.9,7.3,4.7,8.6,5.4,3.2
08426125,Wain,08,Baden-Württemberg,1612,849,763,205,135,70,153,109,44,12.7,8.4,4.3,9.5,6.8,2.7
08435035,Meckenbeuren,08,Baden-Württemberg,13252,6666,6586,1561,883,678,1260,706,554,11.8,6.7,5.1,9.5,5.3,4.2
08435013,Eriskirch,08,Baden-Württemberg,4925,2454,2471,532,321,211,349,199,150,10.8,6.5,4.3,7.1,4.0,3.0
08435029,Kressbronn am Bodensee,08,Baden-Württemberg,8538,4295,4243,922,566,356,811,504,307,10.8,6.6,4.2,9.5,5.9,3.6
08435030,Langenargen,08,Baden-Württemberg,7863,3791,4072,810,512,298,719,427,292,10.3,6.5,3.8,9.1,5.4,3.7
08435016,"Friedrichshafen, Stadt",08,Baden-Württemberg,59108,29319,29789,6577,3885,2692,7349,4367,2982,11.1,6.6,4.6,12.4,7.4,5.0
08435024,Immenstaad am Bodensee,08,Baden-Württemberg,6440,3192,3248,655,445,210,618,366,252,10.2,6.9,3.3,9.6,5.7,3.9
08435005,Bermatingen,08,Baden-Württemberg,3987,2003,1984,453,252,201,340,182,158,11.4,6.3,5.0,8.5,4.6,4.0
08435034,"Markdorf, Stadt",08,Baden-Württemberg,13714,6751,6963,1457,845,612,1535,877,658,10.6,6.2,4.5,11.2,6.4,4.8
08435045,Oberteuringen,08,Baden-Württemberg,4704,2383,2321,491,293,198,410,237,173,10.4,6.2,4.2,8.7,5.0,3.7
08435067,Deggenhausertal,08,Baden-Württemberg,4209,2152,2057,541,312,229,486,275,211,12.9,7.4,5.4,11.5,6.5,5.0
08435010,Daisendorf,08,Baden-Württemberg,1560,776,784,137,79,58,71,29,42,8.8,5.1,3.7,4.6,1.9,2.7
08435018,Hagnau am Bodensee,08,Baden-Württemberg,1421,680,741,123,81,42,199,132,67,8.7,5.7,3.0,14.0,9.3,4.7
08435036,"Meersburg, Stadt",08,Baden-Württemberg,5776,2760,3016,590,347,243,689,382,307,10.2,6.0,4.2,11.9,6.6,5.3
08435054,Stetten,08,Baden-Württemberg,1036,492,544,109,64,45,72,46,26,10.5,6.2,4.3,6.9,4.4,2.5
08435066,Uhldingen-Mühlhofen,08,Baden-Württemberg,8068,3928,4140,906,580,326,598,382,216,11.2,7.2,4.0,7.4,4.7,2.7
08435015,Frickingen,08,Baden-Württemberg,2915,1470,1445,366,229,137,437,255,182,12.6,7.9,4.7,15.0,8.7,6.2
08435020,Heiligenberg,08,Baden-Württemberg,3011,1492,1519,318,200,118,282,178,104,10.6,6.6,3.9,9.4,5.9,3.5
08435052,Salem,08,Baden-Württemberg,11265,5496,5769,1335,791,544,1026,607,419,11.9,7.0,4.8,9.1,5.4,3.7
08435042,Neukirch,08,Baden-Württemberg,2681,1379,1302,344,209,135,159,98,61,12.8,7.8,5.0,5.9,3.7,2.3
08435057,"Tettnang, Stadt",08,Baden-Württemberg,18975,9529,9446,2136,1225,911,2068,1206,862,11.3,6.5,4.8,10.9,6.4,4.5
08435047,Owingen,08,Baden-Württemberg,4246,2108,2138,499,295,204,338,207,131,11.8,6.9,4.8,8.0,4.9,3.1
08435053,Sipplingen,08,Baden-Württemberg,2099,1042,1057,216,134,82,125,66,59,10.3,6.4,3.9,6.0,3.1,2.8
08435059,"Überlingen, Stadt",08,Baden-Württemberg,22408,10411,11997,2303,1393,910,2582,1551,1031,10.3,6.2,4.1,11.5,6.9,4.6
08436008,"Aulendorf, Stadt",08,Baden-Württemberg,9988,4971,5017,1210,703,507,1097,630,467,12.1,7.0,5.1,11.0,6.3,4.7
08436010,"Bad Wurzach, Stadt",08,Baden-Württemberg,14505,7366,7139,1897,1146,751,1528,913,615,13.1,7.9,5.2,10.5,6.3,4.2
08436049,"Isny im Allgäu, Stadt",08,Baden-Württemberg,13602,6765,6837,1791,982,809,1704,946,758,13.2,7.2,5.9,12.5,7.0,5.6
08436052,Kißlegg,08,Baden-Württemberg,9015,4520,4495,1143,687,456,952,537,415,12.7,7.6,5.1,10.6,6.0,4.6
08436094,Argenbühl,08,Baden-Württemberg,6240,3159,3081,863,515,348,605,373,232,13.8,8.3,5.6,9.7,6.0,3.7
08436005,Altshausen,08,Baden-Württemberg,4095,2142,1953,497,273,224,548,339,209,12.1,6.7,5.5,13.4,8.3,5.1
08436019,Boms,08,Baden-Württemberg,627,316,311,78,42,36,53,28,25,12.4,6.7,5.7,8.5,4.5,4.0
08436024,Ebenweiler,08,Baden-Württemberg,1197,627,570,152,94,58,63,39,24,12.7,7.9,4.8,5.3,3.3,2.0
08436027,Eichstegen,08,Baden-Württemberg,491,242,249,64,45,19,24,12,12,13.0,9.2,3.9,4.9,2.4,2.4
08436032,Fleischwangen,08,Baden-Württemberg,674,349,325,94,55,39,-1,-1,-1,13.9,8.2,5.8,-0.1,,
08436040,Guggenhausen,08,Baden-Württemberg,179,85,94,27,20,7,-1,-1,-1,15.1,11.2,3.9,-0.6,,
08436047,Hoßkirch,08,Baden-Württemberg,743,381,362,104,58,46,63,33,30,14.0,7.8,6.2,8.5,4.4,4.0
08436053,Königseggwald,08,Baden-Württemberg,665,335,330,78,40,38,71,44,27,11.7,6.0,5.7,10.7,6.6,4.1
08436067,Riedhausen,08,Baden-Württemberg,638,317,321,104,59,45,65,37,28,16.3,9.2,7.1,10.2,5.8,4.4
08436077,Unterwaldhausen,08,Baden-Württemberg,277,136,141,36,27,9,-1,-1,-1,13.0,9.7,3.2,-0.4,,
08436093,Ebersbach-Musbach,08,Baden-Württemberg,1703,880,823,236,146,90,140,76,64,13.9,8.6,5.3,8.2,4.5,3.8
08436009,"Bad Waldsee, Stadt",08,Baden-Württemberg,20011,9798,10213,2627,1507,1120,2593,1582,1011,13.1,7.5,5.6,13.0,7.9,5.1
08436014,Bergatreute,08,Baden-Württemberg,3108,1602,1506,387,230,157,203,122,81,12.5,7.4,5.1,6.5,3.9,2.6
08436018,Bodnegg,08,Baden-Württemberg,3122,1582,1540,330,195,135,266,166,100,10.6,6.2,4.3,8.5,5.3,3.2
08436039,Grünkraut,08,Baden-Württemberg,3100,1574,1526,345,217,128,353,208,145,11.1,7.0,4.1,11.4,6.7,4.7
08436069,Schlier,08,Baden-Württemberg,3846,1954,1892,438,277,161,261,139,122,11.4,7.2,4.2,6.8,3.6,3.2
08436079,Waldburg,08,Baden-Württemberg,3182,1572,1610,362,252,110,250,156,94,11.4,7.9,3.5,7.9,4.9,3.0
08436003,Aichstetten,08,Baden-Württemberg,2716,1417,1299,400,238,162,343,205,138,14.7,8.8,6.0,12.6,7.5,5.1
08436004,Aitrach,08,Baden-Württemberg,2544,1303,1241,343,201,142,209,109,100,13.5,7.9,5.6,8.2,4.3,3.9
08436055,"Leutkirch im Allgäu, Stadt",08,Baden-Württemberg,22406,11235,11171,3001,1796,1205,2617,1577,1040,13.4,8.0,5.4,11.7,7.0,4.6
08436011,Baienfurt,08,Baden-Württemberg,7138,3545,3593,948,563,385,939,479,460,13.3,7.9,5.4,13.2,6.7,6.4
08436012,Baindt,08,Baden-Württemberg,5088,2523,2565,657,378,279,357,213,144,12.9,7.4,5.5,7.0,4.2,2.8
08436013,Berg,08,Baden-Württemberg,4159,2124,2035,473,274,199,392,228,164,11.4,6.6,4.8,9.4,5.5,3.9
08436064,"Ravensburg, Stadt",08,Baden-Württemberg,49830,24492,25338,5851,3228,2623,9109,5348,3761,11.7,6.5,5.3,18.3,10.7,7.5
08436082,"Weingarten, Stadt",08,Baden-Württemberg,24460,11678,12782,3071,1877,1194,3555,2188,1367,12.6,7.7,4.9,14.5,8.9,5.6
08436078,Vogt,08,Baden-Württemberg,4495,2275,2220,586,366,220,366,232,134,13.0,8.1,4.9,8.1,5.2,3.0
08436085,Wolfegg,08,Baden-Württemberg,3694,1827,1867,461,295,166,376,228,148,12.5,8.0,4.5,10.2,6.2,4.0
08436001,Achberg,08,Baden-Württemberg,1680,830,850,189,110,79,116,67,49,11.2,6.5,4.7,6.9,4.0,2.9
08436006,Amtzell,08,Baden-Württemberg,4155,2055,2100,539,296,243,473,267,206,13.0,7.1,5.8,11.4,6.4,5.0
08436081,"Wangen im Allgäu, Stadt",08,Baden-Württemberg,27093,13184,13909,3469,2033,1436,4332,2606,1726,12.8,7.5,5.3,16.0,9.6,6.4
08436083,Wilhelmsdorf,08,Baden-Württemberg,4938,2490,2448,488,295,193,545,346,199,9.9,6.0,3.9,11.0,7.0,4.0
08436095,Horgenzell,08,Baden-Württemberg,5202,2672,2530,713,406,307,571,336,235,13.7,7.8,5.9,11.0,6.5,4.5
08436087,Wolpertswende,08,Baden-Württemberg,4065,2040,2025,549,332,217,316,175,141,13.5,8.2,5.3,7.8,4.3,3.5
08436096,Fronreute,08,Baden-Württemberg,4625,2350,2275,524,306,218,297,164,133,11.3,6.6,4.7,6.4,3.5,2.9
08437086,Ostrach,08,Baden-Württemberg,6751,3397,3354,888,518,370,768,467,301,13.2,7.7,5.5,11.4,6.9,4.5
08437031,"Gammertingen, Stadt",08,Baden-Württemberg,6341,3236,3105,755,437,318,771,477,294,11.9,6.9,5.0,12.2,7.5,4.6
08437047,"Hettingen, Stadt",08,Baden-Württemberg,1796,913,883,256,151,105,345,139,206,14.3,8.4,5.8,19.2,7.7,11.5
08437082,Neufra,08,Baden-Württemberg,1847,926,921,221,125,96,118,69,49,12.0,6.8,5.2,6.4,3.7,2.7
08437114,"Veringenstadt, Stadt",08,Baden-Württemberg,2149,1083,1066,226,143,83,108,72,36,10.5,6.7,3.9,5.0,3.4,1.7
08437053,Hohentengen,08,Baden-Württemberg,4131,2084,2047,577,352,225,470,282,188,14.0,8.5,5.4,11.4,6.8,4.6
08437076,"Mengen, Stadt",08,Baden-Württemberg,9869,4925,4944,1323,832,491,1598,990,608,13.4,8.4,5.0,16.2,10.0,6.2
08437101,"Scheer, Stadt",08,Baden-Württemberg,2523,1286,1237,283,179,104,199,126,73,11.2,7.1,4.1,7.9,5.0,2.9
08437072,Leibertingen,08,Baden-Württemberg,2087,1057,1030,273,148,125,210,113,97,13.1,7.1,6.0,10.1,5.4,4.6
08437078,"Meßkirch, Stadt",08,Baden-Württemberg,8302,4173,4129,1050,612,438,982,591,391,12.6,7.4,5.3,11.8,7.1,4.7
08437123,Sauldorf,08,Baden-Württemberg,2477,1265,1212,306,162,144,234,119,115,12.4,6.5,5.8,9.4,4.8,4.6
08437056,Illmensee,08,Baden-Württemberg,1973,984,989,266,171,95,234,135,99,13.5,8.7,4.8,11.9,6.8,5.0
08437088,"Pfullendorf, Stadt",08,Baden-Württemberg,13104,6518,6586,1686,915,771,1429,813,616,12.9,7.0,5.9,10.9,6.2,4.7
08437118,Wald,08,Baden-Württemberg,2631,1221,1410,305,190,115,194,106,88,11.6,7.2,4.4,7.4,4.0,3.3
08437124,Herdwangen-Schönach,08,Baden-Württemberg,3412,1686,1726,378,229,149,177,119,58,11.1,6.7,4.4,5.2,3.5,1.7
08437044,Herbertingen,08,Baden-Württemberg,4796,2456,2340,603,371,232,381,214,167,12.6,7.7,4.8,7.9,4.5,3.5
08437100,"Bad Saulgau, Stadt",08,Baden-Württemberg,17286,8417,8869,2152,1290,862,1968,1173,795,12.4,7.5,5.0,11.4,6.8,4.6
08437005,Beuron,08,Baden-Württemberg,664,368,296,74,59,15,85,70,15,11.1,8.9,2.3,12.8,10.5,2.3
08437008,Bingen,08,Baden-Württemberg,2713,1364,1349,341,217,124,142,87,55,12.6,8.0,4.6,5.2,3.2,2.0
08437059,Inzigkofen,08,Baden-Württemberg,2746,1367,1379,325,202,123,233,148,85,11.8,7.4,4.5,8.5,5.4,3.1
08437065,Krauchenwies,08,Baden-Württemberg,4962,2513,2449,601,373,228,477,291,186,12.1,7.5,4.6,9.6,5.9,3.7
08437104,"Sigmaringen, Stadt",08,Baden-Württemberg,18271,9440,8831,1805,1133,672,2257,1411,846,9.9,6.2,3.7,12.4,7.7,4.6
08437105,Sigmaringendorf,08,Baden-Württemberg,3564,1785,1779,380,230,150,231,145,86,10.7,6.5,4.2,6.5,4.1,2.4
08437102,Schwenningen,08,Baden-Württemberg,1579,785,794,208,123,85,133,70,63,13.2,7.8,5.4,8.4,4.4,4.0
08437107,Stetten am kalten Markt,08,Baden-Württemberg,4798,2386,2412,599,367,232,422,239,183,12.5,7.6,4.8,8.8,5.0,3.8
