ags,name,bundesland_id,bundesland,bevoelkerung_total,bevoelkerung_maennlich,bevoelkerung_weiblich,mj_wohnort_insgesamt,mj_wohnort_ausschliesslich,mj_wohnort_nebenjob,mj_arbeitsort_insgesamt,mj_arbeitsort_ausschliesslich,mj_arbeitsort_nebenjob,mj_wohnort_insgesamt_prozent,mj_wohnort_ausschliesslich_prozent,mj_wohnort_nebenjob_prozent,mj_arbeitsort_insgesamt_prozent,mj_arbeitsort_ausschliesslich_prozent,mj_arbeitsort_nebenjob_prozent
15001000,"Dessau-Roßlau, Stadt",15,Sachsen-Anhalt,82919,40311,42608,3855,2906,949,3501,2666,835,4.6,3.5,1.1,4.2,3.2,1.0
15002000,"Halle (Saale), Stadt",15,Sachsen-Anhalt,236991,114581,122410,12634,10096,2538,14518,11488,3030,5.3,4.3,1.1,6.1,4.8,1.3
15003000,"Magdeburg, Landeshauptstadt",15,Sachsen-Anhalt,235723,115810,119913,12836,9870,2966,14062,10708,3354,5.4,4.2,1.3,6.0,4.5,1.4
15081030,"Arendsee (Altmark), Stadt",15,Sachsen-Anhalt,6929,3461,3468,414,291,123,312,218,94,6.0,4.2,1.8,4.5,3.1,1.4
15081135,"Gardelegen, Hansestadt",15,Sachsen-Anhalt,23148,11600,11548,1010,728,282,1097,793,304,4.4,3.1,1.2,4.7,3.4,1.3
15081240,"Kalbe (Milde), Stadt",15,Sachsen-Anhalt,7787,3955,3832,431,316,115,291,213,78,5.5,4.1,1.5,3.7,2.7,1.0
15081280,"Klötze, Stadt",15,Sachsen-Anhalt,10284,5057,5227,457,308,149,448,290,158,4.4,3.0,1.4,4.4,2.8,1.5
15081455,"Salzwedel, Hansestadt",15,Sachsen-Anhalt,24410,12136,12274,1545,1137,408,1751,1271,480,6.3,4.7,1.7,7.2,5.2,2.0
15081026,"Apenburg-Winterfeld, Flecken",15,Sachsen-Anhalt,1735,883,852,77,47,30,159,119,40,4.4,2.7,1.7,9.2,6.9,2.3
15081045,Beetzendorf,15,Sachsen-Anhalt,3236,1644,1592,142,86,56,102,75,27,4.4,2.7,1.7,3.2,2.3,0.8
15081095,Dähre,15,Sachsen-Anhalt,1474,765,709,86,59,27,64,45,19,5.8,4.0,1.8,4.3,3.1,1.3
15081105,"Diesdorf, Flecken",15,Sachsen-Anhalt,2385,1173,1212,130,87,43,74,49,25,5.5,3.6,1.8,3.1,2.1,1.0
15081225,Jübar,15,Sachsen-Anhalt,1660,840,820,83,57,26,42,28,14,5.0,3.4,1.6,2.5,1.7,0.8
15081290,Kuhfelde,15,Sachsen-Anhalt,1138,587,551,54,34,20,9,6,3,4.7,3.0,1.8,0.8,0.5,0.3
15081440,Rohrberg,15,Sachsen-Anhalt,1103,549,554,60,44,16,25,18,7,5.4,4.0,1.5,2.3,1.6,0.6
15081545,Wallstawe,15,Sachsen-Anhalt,875,454,421,48,33,15,23,18,5,5.5,3.8,1.7,2.6,2.1,0.6
15082005,"Aken (Elbe), Stadt",15,Sachsen-Anhalt,7799,3808,3991,350,276,74,225,180,45,4.5,3.5,0.9,2.9,2.3,0.6
15082015,"Bitterfeld-Wolfen, Stadt",15,Sachsen-Anhalt,40480,19572,20908,1705,1301,404,1715,1261,454,4.2,3.2,1.0,4.2,3.1,1.1
15082180,"Köthen (Anhalt), Stadt",15,Sachsen-Anhalt,26519,12963,13556,1381,1119,262,1490,1199,291,5.2,4.2,1.0,5.6,4.5,1.1
15082241,Muldestausee,15,Sachsen-Anhalt,11899,5949,5950,450,322,128,273,199,74,3.8,2.7,1.1,2.3,1.7,0.6
15082256,Osternienburger Land,15,Sachsen-Anhalt,8867,4496,4371,415,319,96,212,160,52,4.7,3.6,1.1,2.4,1.8,0.6
15082301,"Raguhn-Jeßnitz, Stadt",15,Sachsen-Anhalt,9493,4735,4758,363,270,93,241,188,53,3.8,2.8,1.0,2.5,2.0,0.6
15082340,"Sandersdorf-Brehna, Stadt",15,Sachsen-Anhalt,14478,7071,7407,575,431,144,387,272,115,4.0,3.0,1.0,2.7,1.9,0.8
15082377,"Südliches Anhalt, Stadt",15,Sachsen-Anhalt,13810,6861,6949,478,372,106,323,260,63,3.5,2.7,0.8,2.3,1.9,0.5
15082430,"Zerbst/Anhalt, Stadt",15,Sachsen-Anhalt,22055,10823,11232,945,717,228,945,705,240,4.3,3.3,1.0,4.3,3.2,1.1
15082440,"Zörbig, Stadt",15,Sachsen-Anhalt,9417,4662,4755,405,305,100,345,256,89,4.3,3.2,1.1,3.7,2.7,0.9
15083040,Barleben,15,Sachsen-Anhalt,9229,4529,4700,419,287,132,769,554,215,4.5,3.1,1.4,8.3,6.0,2.3
15083270,"Haldensleben, Stadt",15,Sachsen-Anhalt,19439,9696,9743,913,632,281,1240,896,344,4.7,3.3,1.4,6.4,4.6,1.8
15083298,Hohe Börde,15,Sachsen-Anhalt,18168,9130,9038,891,607,284,592,426,166,4.9,3.3,1.6,3.3,2.3,0.9
15083390,Niedere Börde,15,Sachsen-Anhalt,7066,3596,3470,342,225,117,196,144,52,4.8,3.2,1.7,2.8,2.0,0.7
15083411,"Oebisfelde-Weferlingen, Stadt",15,Sachsen-Anhalt,13916,7004,6912,581,418,163,370,274,96,4.2,3.0,1.2,2.7,2.0,0.7
15083415,"Oschersleben (Bode), Stadt",15,Sachsen-Anhalt,19883,9732,10151,986,732,254,916,711,205,5.0,3.7,1.3,4.6,3.6,1.0
15083490,Sülzetal,15,Sachsen-Anhalt,9070,4541,4529,427,290,137,525,383,142,4.7,3.2,1.5,5.8,4.2,1.6
15083531,"Wanzleben-Börde, Stadt",15,Sachsen-Anhalt,14225,7109,7116,649,481,168,529,393,136,4.6,3.4,1.2,3.7,2.8,1.0
15083565,"Wolmirstedt, Stadt",15,Sachsen-Anhalt,11620,5710,5910,524,399,125,513,410,103,4.5,3.4,1.1,4.4,3.5,0.9
15083030,Angern,15,Sachsen-Anhalt,2025,1023,1002,88,62,26,61,43,18,4.3,3.1,1.3,3.0,2.1,0.9
15083120,Burgstall,15,Sachsen-Anhalt,1531,736,795,69,48,21,56,40,16,4.5,3.1,1.4,3.7,2.6,1.0
15083130,Colbitz,15,Sachsen-Anhalt,3320,1717,1603,146,118,28,78,61,17,4.4,3.6,0.8,2.3,1.8,0.5
15083361,Loitsche-Heinrichsberg,15,Sachsen-Anhalt,955,495,460,35,28,7,38,26,12,3.7,2.9,0.7,4.0,2.7,1.3
15083440,Rogätz,15,Sachsen-Anhalt,2148,1040,1108,90,71,19,62,47,15,4.2,3.3,0.9,2.9,2.2,0.7
15083557,Westheide,15,Sachsen-Anhalt,1723,889,834,95,75,20,34,29,5,5.5,4.4,1.2,2.0,1.7,0.3
15083580,Zielitz,15,Sachsen-Anhalt,1786,918,868,71,54,17,-1,-1,-1,4.0,3.0,1.0,-0.1,,
15083020,Altenhausen,15,Sachsen-Anhalt,1120,565,555,54,36,18,47,26,21,4.8,3.2,1.6,4.2,2.3,1.9
15083060,Beendorf,15,Sachsen-Anhalt,931,474,457,45,32,13,17,12,5,4.8,3.4,1.4,1.8,1.3,0.5
15083115,Bülstringen,15,Sachsen-Anhalt,880,446,434,44,27,17,60,34,26,5.0,3.1,1.9,6.8,3.9,3.0
15083125,Calvörde,15,Sachsen-Anhalt,3488,1752,1736,186,126,60,103,73,30,5.3,3.6,1.7,3.0,2.1,0.9
15083205,Erxleben,15,Sachsen-Anhalt,2889,1479,1410,157,110,47,96,72,24,5.4,3.8,1.6,3.3,2.5,0.8
15083230,Flechtingen,15,Sachsen-Anhalt,2857,1428,1429,123,93,30,123,101,22,4.3,3.3,1.1,4.3,3.5,0.8
15083323,Ingersleben,15,Sachsen-Anhalt,1373,698,675,60,49,11,36,30,6,4.4,3.6,0.8,2.6,2.2,0.4
15083190,Eilsleben,15,Sachsen-Anhalt,3848,1905,1943,173,129,44,246,190,56,4.5,3.4,1.1,6.4,4.9,1.5
15083275,Harbke,15,Sachsen-Anhalt,1896,1139,757,85,59,26,37,29,8,4.5,3.1,1.4,2.0,1.5,0.4
15083320,Hötensleben,15,Sachsen-Anhalt,3655,1837,1818,184,134,50,132,96,36,5.0,3.7,1.4,3.6,2.6,1.0
15083485,Sommersdorf,15,Sachsen-Anhalt,1419,715,704,66,51,15,-1,-1,-1,4.7,3.6,1.1,-0.1,,
15083505,Ummendorf,15,Sachsen-Anhalt,987,477,510,54,34,20,46,36,10,5.5,3.4,2.0,4.7,3.6,1.0
15083515,Völpke,15,Sachsen-Anhalt,1329,656,673,67,54,13,45,31,14,5.0,4.1,1.0,3.4,2.3,1.1
15083535,Wefensleben,15,Sachsen-Anhalt,1820,924,896,83,70,13,53,46,7,4.6,3.8,0.7,2.9,2.5,0.4
15083025,Am Großen Bruch,15,Sachsen-Anhalt,2139,1070,1069,77,54,23,33,28,5,3.6,2.5,1.1,1.5,1.3,0.2
15083035,Ausleben,15,Sachsen-Anhalt,1669,855,814,87,65,22,25,18,7,5.2,3.9,1.3,1.5,1.1,0.4
15083245,"Gröningen, Stadt",15,Sachsen-Anhalt,3621,1804,1817,163,113,50,86,57,29,4.5,3.1,1.4,2.4,1.6,0.8
15083355,"Kroppenstedt, Stadt",15,Sachsen-Anhalt,1448,730,718,65,43,22,58,37,21,4.5,3.0,1.5,4.0,2.6,1.5
15084130,Elsteraue,15,Sachsen-Anhalt,8452,4220,4232,349,256,93,156,125,31,4.1,3.0,1.1,1.8,1.5,0.4
15084235,"Hohenmölsen, Stadt",15,Sachsen-Anhalt,9822,4747,5075,421,326,95,271,213,58,4.3,3.3,1.0,2.8,2.2,0.6
15084315,"Lützen, Stadt",15,Sachsen-Anhalt,8625,4282,4343,365,276,89,338,265,73,4.2,3.2,1.0,3.9,3.1,0.8
15084355,"Naumburg (Saale), Stadt",15,Sachsen-Anhalt,33012,15990,17022,1724,1319,405,1616,1261,355,5.2,4.0,1.2,4.9,3.8,1.1
15084490,"Teuchern, Stadt",15,Sachsen-Anhalt,8262,4140,4122,308,234,74,171,128,43,3.7,2.8,0.9,2.1,1.5,0.5
15084550,"Weißenfels, Stadt",15,Sachsen-Anhalt,40398,20423,19975,1766,1351,415,1545,1165,380,4.4,3.3,1.0,3.8,2.9,0.9
15084590,"Zeitz, Stadt",15,Sachsen-Anhalt,29052,14054,14998,1224,1016,208,1380,1138,242,4.2,3.5,0.7,4.8,3.9,0.8
15084012,An der Poststraße,15,Sachsen-Anhalt,1698,885,813,82,67,15,42,34,8,4.8,3.9,0.9,2.5,2.0,0.5
15084015,"Bad Bibra, Stadt",15,Sachsen-Anhalt,2783,1387,1396,155,114,41,107,79,28,5.6,4.1,1.5,3.8,2.8,1.0
15084125,"Eckartsberga, Stadt",15,Sachsen-Anhalt,2449,1254,1195,120,92,28,95,76,19,4.9,3.8,1.1,3.9,3.1,0.8
15084132,Finne,15,Sachsen-Anhalt,1186,606,580,32,21,11,13,-1,-1,2.7,1.8,0.9,1.1,,
15084133,Finneland,15,Sachsen-Anhalt,1092,556,536,64,43,21,44,27,17,5.9,3.9,1.9,4.0,2.5,1.6
15084246,Kaiserpfalz,15,Sachsen-Anhalt,1585,813,772,65,52,13,44,36,8,4.1,3.3,0.8,2.8,2.3,0.5
15084282,Lanitz-Hassel-Tal,15,Sachsen-Anhalt,1131,565,566,50,36,14,14,7,7,4.4,3.2,1.2,1.2,0.6,0.6
15084115,Droyßig,15,Sachsen-Anhalt,2016,999,1017,91,77,14,53,47,6,4.5,3.8,0.7,2.6,2.3,0.3
15084207,Gutenborn,15,Sachsen-Anhalt,1821,947,874,87,64,23,79,52,27,4.8,3.5,1.3,4.3,2.9,1.5
15084275,Kretzschau,15,Sachsen-Anhalt,2505,1248,1257,128,99,29,107,81,26,5.1,4.0,1.2,4.3,3.2,1.0
15084442,Schnaudertal,15,Sachsen-Anhalt,972,509,463,41,31,10,22,15,7,4.2,3.2,1.0,2.3,1.5,0.7
15084565,Wetterzeube,15,Sachsen-Anhalt,1833,911,922,76,53,23,30,18,12,4.1,2.9,1.3,1.6,1.0,0.7
15084025,Balgstädt,15,Sachsen-Anhalt,1143,583,560,75,55,20,37,26,11,6.6,4.8,1.7,3.2,2.3,1.0
15084135,"Freyburg (Unstrut), Stadt",15,Sachsen-Anhalt,4735,2318,2417,302,227,75,339,255,84,6.4,4.8,1.6,7.2,5.4,1.8
15084150,Gleina,15,Sachsen-Anhalt,1266,652,614,47,29,18,26,11,15,3.7,2.3,1.4,2.1,0.9,1.2
15084170,Goseck,15,Sachsen-Anhalt,1018,502,516,49,40,9,34,26,8,4.8,3.9,0.9,3.3,2.6,0.8
15084250,Karsdorf,15,Sachsen-Anhalt,1655,819,836,85,70,15,64,58,6,5.1,4.2,0.9,3.9,3.5,0.4
15084285,"Laucha an der Unstrut, Stadt",15,Sachsen-Anhalt,2969,1503,1466,155,125,30,119,87,32,5.2,4.2,1.0,4.0,2.9,1.1
15084360,"Nebra (Unstrut), Stadt",15,Sachsen-Anhalt,3349,1650,1699,164,119,45,109,81,28,4.9,3.6,1.3,3.3,2.4,0.8
15084013,Meineweh,15,Sachsen-Anhalt,1075,585,490,40,34,6,31,24,7,3.7,3.2,0.6,2.9,2.2,0.7
15084335,Mertendorf,15,Sachsen-Anhalt,1662,844,818,90,66,24,53,45,8,5.4,4.0,1.4,3.2,2.7,0.5
15084341,Molauer Land,15,Sachsen-Anhalt,1055,535,520,56,40,16,37,22,15,5.3,3.8,1.5,3.5,2.1,1.4
15084375,"Osterfeld, Stadt",15,Sachsen-Anhalt,2490,1272,1218,106,83,23,106,91,15,4.3,3.3,0.9,4.3,3.7,0.6
15084445,Schönburg,15,Sachsen-Anhalt,1070,547,523,43,29,14,56,53,3,4.0,2.7,1.3,5.2,5.0,0.3
15084470,"Stößen, Stadt",15,Sachsen-Anhalt,906,425,481,42,31,11,36,28,8,4.6,3.4,1.2,4.0,3.1,0.9
15084560,Wethau,15,Sachsen-Anhalt,994,505,489,49,41,8,13,-1,-1,4.9,4.1,0.8,1.3,,
15085040,"Ballenstedt, Stadt",15,Sachsen-Anhalt,9130,4452,4678,353,272,81,291,234,57,3.9,3.0,0.9,3.2,2.6,0.6
15085055,"Blankenburg (Harz), Stadt",15,Sachsen-Anhalt,20294,9799,10495,887,673,214,946,719,227,4.4,3.3,1.1,4.7,3.5,1.1
15085110,"Falkenstein/Harz, Stadt",15,Sachsen-Anhalt,5510,2790,2720,253,194,59,163,125,38,4.6,3.5,1.1,3.0,2.3,0.7
15085135,"Halberstadt, Stadt",15,Sachsen-Anhalt,43768,22374,21394,1913,1492,421,1759,1360,399,4.4,3.4,1.0,4.0,3.1,0.9
15085145,"Harzgerode, Stadt",15,Sachsen-Anhalt,8068,4041,4027,359,268,91,612,475,137,4.4,3.3,1.1,7.6,5.9,1.7
15085185,Huy,15,Sachsen-Anhalt,7340,3692,3648,396,299,97,396,300,96,5.4,4.1,1.3,5.4,4.1,1.3
15085190,"Ilsenburg (Harz), Stadt",15,Sachsen-Anhalt,9475,4690,4785,548,374,174,439,308,131,5.8,3.9,1.8,4.6,3.3,1.4
15085227,Nordharz,15,Sachsen-Anhalt,7867,3915,3952,418,287,131,212,151,61,5.3,3.6,1.7,2.7,1.9,0.8
15085228,"Oberharz am Brocken, Stadt",15,Sachsen-Anhalt,10771,5204,5567,622,444,178,522,379,143,5.8,4.1,1.7,4.8,3.5,1.3
15085230,"Osterwieck, Stadt",15,Sachsen-Anhalt,11292,5698,5594,630,426,204,460,331,129,5.6,3.8,1.8,4.1,2.9,1.1
15085235,"Quedlinburg, Stadt",15,Sachsen-Anhalt,24555,11701,12854,1386,1030,356,1559,1147,412,5.6,4.2,1.4,6.3,4.7,1.7
15085330,"Thale, Stadt",15,Sachsen-Anhalt,17639,8691,8948,875,646,229,744,575,169,5.0,3.7,1.3,4.2,3.3,1.0
15085370,"Wernigerode, Stadt",15,Sachsen-Anhalt,33108,15696,17412,2125,1582,543,2432,1817,615,6.4,4.8,1.6,7.3,5.5,1.9
15085090,Ditfurt,15,Sachsen-Anhalt,1544,779,765,84,62,22,55,40,15,5.4,4.0,1.4,3.6,2.6,1.0
15085125,Groß Quenstedt,15,Sachsen-Anhalt,931,464,467,32,24,8,8,-1,-1,3.4,2.6,0.9,0.9,,
15085140,Harsleben,15,Sachsen-Anhalt,2180,1084,1096,99,73,26,31,21,10,4.5,3.3,1.2,1.4,1.0,0.5
15085160,Hedersleben,15,Sachsen-Anhalt,1353,669,684,75,54,21,36,27,9,5.5,4.0,1.6,2.7,2.0,0.7
15085285,"Schwanebeck, Stadt",15,Sachsen-Anhalt,2515,1244,1271,113,84,29,81,60,21,4.5,3.3,1.2,3.2,2.4,0.8
15085287,Selke-Aue,15,Sachsen-Anhalt,1435,725,710,62,43,19,22,-1,-1,4.3,3.0,1.3,1.5,,
15085365,"Wegeleben, Stadt",15,Sachsen-Anhalt,2591,1318,1273,120,84,36,83,62,21,4.6,3.2,1.4,3.2,2.4,0.8
15086005,Biederitz,15,Sachsen-Anhalt,8479,4174,4305,396,285,111,244,174,70,4.7,3.4,1.3,2.9,2.1,0.8
15086015,"Burg, Stadt",15,Sachsen-Anhalt,22970,11666,11304,1060,833,227,1180,928,252,4.6,3.6,1.0,5.1,4.0,1.1
15086035,Elbe-Parey,15,Sachsen-Anhalt,6958,3453,3505,298,235,63,191,150,41,4.3,3.4,0.9,2.7,2.2,0.6
15086040,"Genthin, Stadt",15,Sachsen-Anhalt,14610,7325,7285,715,550,165,818,633,185,4.9,3.8,1.1,5.6,4.3,1.3
15086055,"Gommern, Stadt",15,Sachsen-Anhalt,10540,5145,5395,449,338,111,486,335,151,4.3,3.2,1.1,4.6,3.2,1.4
15086080,"Jerichow, Stadt",15,Sachsen-Anhalt,7019,3547,3472,316,249,67,220,178,42,4.5,3.5,1.0,3.1,2.5,0.6
15086140,"Möckern, Stadt",15,Sachsen-Anhalt,12980,6519,6461,617,473,144,454,362,92,4.8,3.6,1.1,3.5,2.8,0.7
15086145,Möser,15,Sachsen-Anhalt,8137,4041,4096,360,242,118,220,165,55,4.4,3.0,1.5,2.7,2.0,0.7
15087015,"Allstedt, Stadt",15,Sachsen-Anhalt,7985,4003,3982,388,307,81,292,243,49,4.9,3.8,1.0,3.7,3.0,0.6
15087031,"Arnstein, Stadt",15,Sachsen-Anhalt,6831,3400,3431,247,196,51,142,110,32,3.6,2.9,0.7,2.1,1.6,0.5
15087130,"Eisleben, Lutherstadt",15,Sachsen-Anhalt,24198,11876,12322,1116,867,249,1125,848,277,4.6,3.6,1.0,4.6,3.5,1.1
15087165,"Gerbstedt, Stadt",15,Sachsen-Anhalt,7462,3708,3754,317,250,67,249,202,47,4.2,3.4,0.9,3.3,2.7,0.6
15087220,"Hettstedt, Stadt",15,Sachsen-Anhalt,14533,7151,7382,560,453,107,529,421,108,3.9,3.1,0.7,3.6,2.9,0.7
15087275,"Mansfeld, Stadt",15,Sachsen-Anhalt,9089,4542,4547,387,297,90,348,291,57,4.3,3.3,1.0,3.8,3.2,0.6
15087370,"Sangerhausen, Stadt",15,Sachsen-Anhalt,27752,13674,14078,1342,1029,313,1429,1059,370,4.8,3.7,1.1,5.1,3.8,1.3
15087386,Seegebiet Mansfelder Land,15,Sachsen-Anhalt,9132,4530,4602,363,271,92,452,363,89,4.0,3.0,1.0,4.9,4.0,1.0
15087412,Südharz,15,Sachsen-Anhalt,9649,4804,4845,409,326,83,324,262,62,4.2,3.4,0.9,3.4,2.7,0.6
15087055,Berga,15,Sachsen-Anhalt,1738,882,856,93,65,28,100,74,26,5.4,3.7,1.6,5.8,4.3,1.5
15087101,Brücken-Hackpfüffel,15,Sachsen-Anhalt,1015,519,496,33,25,8,13,10,3,3.3,2.5,0.8,1.3,1.0,0.3
15087125,Edersleben,15,Sachsen-Anhalt,1006,499,507,46,27,19,30,25,5,4.6,2.7,1.9,3.0,2.5,0.5
15087250,"Kelbra (Kyffhäuser), Stadt",15,Sachsen-Anhalt,3453,1718,1735,157,121,36,107,85,22,4.5,3.5,1.0,3.1,2.5,0.6
15087440,Wallhausen,15,Sachsen-Anhalt,2530,1238,1292,115,84,31,101,72,29,4.5,3.3,1.2,4.0,2.8,1.1
15087010,Ahlsdorf,15,Sachsen-Anhalt,1583,790,793,58,41,17,28,22,6,3.7,2.6,1.1,1.8,1.4,0.4
15087045,Benndorf,15,Sachsen-Anhalt,2117,988,1129,89,79,10,36,28,8,4.2,3.7,0.5,1.7,1.3,0.4
15087070,Blankenheim,15,Sachsen-Anhalt,1222,609,613,68,49,19,26,20,6,5.6,4.0,1.6,2.1,1.6,0.5
15087075,Bornstedt,15,Sachsen-Anhalt,820,413,407,38,29,9,11,-1,-1,4.6,3.5,1.1,1.3,,
15087205,Helbra,15,Sachsen-Anhalt,4080,1943,2137,138,109,29,143,112,31,3.4,2.7,0.7,3.5,2.7,0.8
15087210,Hergisdorf,15,Sachsen-Anhalt,1592,780,812,57,43,14,11,-1,-1,3.6,2.7,0.9,0.7,,
15087260,Klostermansfeld,15,Sachsen-Anhalt,2415,1170,1245,81,70,11,65,53,12,3.4,2.9,0.5,2.7,2.2,0.5
15087470,Wimmelburg,15,Sachsen-Anhalt,1206,594,612,51,35,16,23,18,5,4.2,2.9,1.3,1.9,1.5,0.4
15088020,"Bad Dürrenberg, Stadt",15,Sachsen-Anhalt,11763,5796,5967,476,357,119,332,246,86,4.0,3.0,1.0,2.8,2.1,0.7
15088025,"Bad Lauchstädt, Goethestadt",15,Sachsen-Anhalt,8817,4350,4467,415,327,88,272,209,63,4.7,3.7,1.0,3.1,2.4,0.7
15088065,"Braunsbedra, Stadt",15,Sachsen-Anhalt,11167,5714,5453,449,359,90,654,492,162,4.0,3.2,0.8,5.9,4.4,1.5
15088150,Kabelsketal,15,Sachsen-Anhalt,8767,4424,4343,435,307,128,557,420,137,5.0,3.5,1.5,6.4,4.8,1.6
15088195,"Landsberg, Stadt",15,Sachsen-Anhalt,14996,7517,7479,667,427,240,788,543,245,4.4,2.8,1.6,5.3,3.6,1.6
15088205,"Leuna, Stadt",15,Sachsen-Anhalt,13832,6889,6943,660,490,170,1473,1256,217,4.8,3.5,1.2,10.6,9.1,1.6
15088216,"Wettin-Löbejün, Stadt",15,Sachsen-Anhalt,9955,4935,5020,478,347,131,255,200,55,4.8,3.5,1.3,2.6,2.0,0.6
15088220,"Merseburg, Stadt",15,Sachsen-Anhalt,34052,16481,17571,1555,1258,297,1842,1450,392,4.6,3.7,0.9,5.4,4.3,1.2
15088235,"Mücheln (Geiseltal), Stadt",15,Sachsen-Anhalt,9057,4506,4551,351,265,86,249,189,60,3.9,2.9,0.9,2.7,2.1,0.7
15088295,Petersberg,15,Sachsen-Anhalt,9677,4821,4856,441,308,133,298,234,64,4.6,3.2,1.4,3.1,2.4,0.7
15088305,"Querfurt, Stadt",15,Sachsen-Anhalt,10984,5355,5629,606,443,163,626,453,173,5.5,4.0,1.5,5.7,4.1,1.6
15088319,Salzatal,15,Sachsen-Anhalt,11566,5642,5924,525,371,154,357,279,78,4.5,3.2,1.3,3.1,2.4,0.7
15088330,Schkopau,15,Sachsen-Anhalt,10935,5471,5464,484,342,142,320,231,89,4.4,3.1,1.3,2.9,2.1,0.8
15088365,Teutschenthal,15,Sachsen-Anhalt,12956,6436,6520,554,403,151,427,314,113,4.3,3.1,1.2,3.3,2.4,0.9
15088030,Barnstädt,15,Sachsen-Anhalt,1003,511,492,64,53,11,25,22,3,6.4,5.3,1.1,2.5,2.2,0.3
15088100,Farnstädt,15,Sachsen-Anhalt,1487,754,733,72,55,17,19,-1,-1,4.8,3.7,1.1,1.3,,
15088250,Nemsdorf-Göhrendorf,15,Sachsen-Anhalt,855,449,406,39,29,10,22,-1,-1,4.6,3.4,1.2,2.6,,
15088265,Obhausen,15,Sachsen-Anhalt,2261,1141,1120,85,61,24,36,29,7,3.8,2.7,1.1,1.6,1.3,0.3
15088340,"Schraplau, Stadt",15,Sachsen-Anhalt,1142,568,574,50,38,12,30,25,5,4.4,3.3,1.1,2.6,2.2,0.4
15088355,Steigra,15,Sachsen-Anhalt,1159,579,580,60,49,11,61,51,10,5.2,4.2,0.9,5.3,4.4,0.9
15089015,"Aschersleben, Stadt",15,Sachsen-Anhalt,27793,13440,14353,1423,1161,262,1424,1145,279,5.1,4.2,0.9,5.1,4.1,1.0
15089026,"Barby, Stadt",15,Sachsen-Anhalt,8665,4288,4377,383,305,78,285,224,61,4.4,3.5,0.9,3.3,2.6,0.7
15089030,"Bernburg (Saale), Stadt",15,Sachsen-Anhalt,33920,16606,17314,1607,1274,333,1479,1140,339,4.7,3.8,1.0,4.4,3.4,1.0
15089042,Bördeland,15,Sachsen-Anhalt,7641,3817,3824,327,224,103,212,156,56,4.3,2.9,1.3,2.8,2.0,0.7
15089055,"Calbe (Saale), Stadt",15,Sachsen-Anhalt,8994,4344,4650,436,364,72,434,339,95,4.8,4.0,0.8,4.8,3.8,1.1
15089175,"Hecklingen, Stadt",15,Sachsen-Anhalt,7185,3550,3635,252,195,57,222,168,54,3.5,2.7,0.8,3.1,2.3,0.8
15089195,"Könnern, Stadt",15,Sachsen-Anhalt,8603,4270,4333,375,295,80,235,189,46,4.4,3.4,0.9,2.7,2.2,0.5
15089235,"Nienburg (Saale), Stadt",15,Sachsen-Anhalt,6460,3204,3256,249,188,61,133,104,29,3.9,2.9,0.9,2.1,1.6,0.4
15089305,"Schönebeck (Elbe), Stadt",15,Sachsen-Anhalt,31366,15158,16208,1490,1161,329,1515,1174,341,4.8,3.7,1.0,4.8,3.7,1.1
15089307,"Seeland, Stadt",15,Sachsen-Anhalt,8257,4112,4145,255,193,62,272,212,60,3.1,2.3,0.8,3.3,2.6,0.7
15089310,"Staßfurt, Stadt",15,Sachsen-Anhalt,26634,12945,13689,1279,995,284,1137,873,264,4.8,3.7,1.1,4.3,3.3,1.0
15089041,Bördeaue,15,Sachsen-Anhalt,1839,910,929,89,68,21,79,68,11,4.8,3.7,1.1,4.3,3.7,0.6
15089043,Börde-Hakel,15,Sachsen-Anhalt,3104,1554,1550,116,91,25,64,46,18,3.7,2.9,0.8,2.1,1.5,0.6
15089045,Borne,15,Sachsen-Anhalt,1250,636,614,56,44,12,30,23,7,4.5,3.5,1.0,2.4,1.8,0.6
15089075,"Egeln, Stadt",15,Sachsen-Anhalt,3394,1668,1726,179,134,45,222,168,54,5.3,3.9,1.3,6.5,4.9,1.6
15089365,Wolmirsleben,15,Sachsen-Anhalt,1351,672,679,58,46,12,32,21,11,4.3,3.4,0.9,2.4,1.6,0.8
15089005,"Alsleben (Saale), Stadt",15,Sachsen-Anhalt,2526,1219,1307,105,82,23,84,73,11,4.2,3.2,0.9,3.3,2.9,0.4
15089130,Giersleben,15,Sachsen-Anhalt,1039,502,537,36,30,6,15,-1,-1,3.5,2.9,0.6,1.4,,
15089165,"Güsten, Stadt",15,Sachsen-Anhalt,4298,2097,2201,155,130,25,114,93,21,3.6,3.0,0.6,2.7,2.2,0.5
15089185,Ilberstedt,15,Sachsen-Anhalt,1050,510,540,55,45,10,44,33,11,5.2,4.3,1.0,4.2,3.1,1.0
15089245,Plötzkau,15,Sachsen-Anhalt,1326,659,667,51,37,14,33,-1,-1,3.8,2.8,1.1,2.5,,
15090070,"Bismark (Altmark), Stadt",15,Sachsen-Anhalt,8418,4238,4180,212,149,63,266,187,79,2.5,1.8,0.7,3.2,2.2,0.9
15090225,"Havelberg, Hansestadt",15,Sachsen-Anhalt,6619,3285,3334,383,263,120,398,268,130,5.8,4.0,1.8,6.0,4.0,2.0
15090415,"Osterburg (Altmark), Hansestadt",15,Sachsen-Anhalt,10076,4907,5169,552,416,136,479,358,121,5.5,4.1,1.3,4.8,3.6,1.2
15090535,"Stendal, Hansestadt",15,Sachsen-Anhalt,40269,19726,20543,2146,1691,455,2181,1707,474,5.3,4.2,1.1,5.4,4.2,1.2
15090546,"Tangerhütte, Stadt",15,Sachsen-Anhalt,11007,5498,5509,603,446,157,474,357,117,5.5,4.1,1.4,4.3,3.2,1.1
15090550,"Tangermünde, Stadt",15,Sachsen-Anhalt,10447,5029,5418,542,393,149,465,344,121,5.2,3.8,1.4,4.5,3.3,1.2
15090010,"Arneburg, Stadt",15,Sachsen-Anhalt,1528,734,794,74,57,17,101,32,69,4.8,3.7,1.1,6.6,2.1,4.5
15090135,Eichstedt (Altmark),15,Sachsen-Anhalt,892,448,444,57,36,21,43,27,16,6.4,4.0,2.4,4.8,3.0,1.8
15090180,Goldbeck,15,Sachsen-Anhalt,1449,707,742,168,119,49,47,39,8,11.6,8.2,3.4,3.2,2.7,0.6
15090220,Hassel,15,Sachsen-Anhalt,950,467,483,45,24,21,23,-1,-1,4.7,2.5,2.2,2.4,,
15090245,Hohenberg-Krusemark,15,Sachsen-Anhalt,1236,615,621,66,47,19,35,26,9,5.3,3.8,1.5,2.8,2.1,0.7
15090270,Iden,15,Sachsen-Anhalt,847,441,406,42,30,12,28,17,11,5.0,3.5,1.4,3.3,2.0,1.3
15090435,Rochau,15,Sachsen-Anhalt,1025,531,494,42,28,14,32,26,6,4.1,2.7,1.4,3.1,2.5,0.6
15090610,"Werben (Elbe), Hansestadt",15,Sachsen-Anhalt,1142,590,552,70,54,16,36,27,9,6.1,4.7,1.4,3.2,2.4,0.8
15090285,Kamern,15,Sachsen-Anhalt,1212,643,569,65,49,16,44,36,8,5.4,4.0,1.3,3.6,3.0,0.7
15090310,Klietz,15,Sachsen-Anhalt,2484,1510,974,78,52,26,48,34,14,3.1,2.1,1.0,1.9,1.4,0.6
15090445,"Sandau (Elbe), Stadt",15,Sachsen-Anhalt,881,425,456,66,50,16,30,20,10,7.5,5.7,1.8,3.4,2.3,1.1
15090485,Schollene,15,Sachsen-Anhalt,1220,627,593,40,25,15,32,20,12,3.3,2.0,1.2,2.6,1.6,1.0
15090500,Schönhausen (Elbe),15,Sachsen-Anhalt,2147,1066,1081,96,63,33,48,31,17,4.5,2.9,1.5,2.2,1.4,0.8
15090631,Wust-Fischbeck,15,Sachsen-Anhalt,1307,672,635,56,44,12,33,27,6,4.3,3.4,0.9,2.5,2.1,0.5
15090003,Aland,15,Sachsen-Anhalt,1426,722,704,87,62,25,36,26,10,6.1,4.3,1.8,2.5,1.8,0.7
15090007,Altmärkische Höhe,15,Sachsen-Anhalt,1899,1002,897,105,72,33,66,51,15,5.5,3.8,1.7,3.5,2.7,0.8
15090008,Altmärkische Wische,15,Sachsen-Anhalt,850,425,425,47,38,9,14,-1,-1,5.5,4.5,1.1,1.6,,
15090520,"Seehausen (Altmark), Hansestadt",15,Sachsen-Anhalt,5033,2450,2583,245,185,60,233,181,52,4.9,3.7,1.2,4.6,3.6,1.0
15090635,Zehrental,15,Sachsen-Anhalt,898,436,462,56,43,13,27,21,6,6.2,4.8,1.4,3.0,2.3,0.7
15091010,"Annaburg, Stadt",15,Sachsen-Anhalt,6932,3451,3481,336,272,64,207,163,44,4.8,3.9,0.9,3.0,2.4,0.6
15091020,"Bad Schmiedeberg, Stadt",15,Sachsen-Anhalt,8475,4184,4291,373,278,95,249,181,68,4.4,3.3,1.1,2.9,2.1,0.8
15091060,"Coswig (Anhalt), Stadt",15,Sachsen-Anhalt,12184,6125,6059,578,463,115,576,449,127,4.7,3.8,0.9,4.7,3.7,1.0
15091110,"Gräfenhainichen, Stadt",15,Sachsen-Anhalt,11944,5811,6133,567,445,122,435,343,92,4.7,3.7,1.0,3.6,2.9,0.8
15091145,"Jessen (Elster), Stadt",15,Sachsen-Anhalt,14215,7114,7101,656,499,157,644,490,154,4.6,3.5,1.1,4.5,3.4,1.1
15091160,"Kemberg, Stadt",15,Sachsen-Anhalt,9954,4920,5034,438,324,114,307,233,74,4.4,3.3,1.1,3.1,2.3,0.7
15091241,"Oranienbaum-Wörlitz, Stadt",15,Sachsen-Anhalt,8980,4692,4288,401,309,92,322,247,75,4.5,3.4,1.0,3.6,2.8,0.8
15091375,"Wittenberg, Lutherstadt",15,Sachsen-Anhalt,46475,22475,24000,2410,1854,556,2296,1780,516,5.2,4.0,1.2,4.9,3.8,1.1
15091391,"Zahna-Elster, Stadt",15,Sachsen-Anhalt,9288,4655,4633,493,370,123,352,259,93,5.3,4.0,1.3,3.8,2.8,1.0
