ags,name,bundesland_id,bundesland,bevoelkerung_total,bevoelkerung_maennlich,bevoelkerung_weiblich,mj_wohnort_insgesamt,mj_wohnort_ausschliesslich,mj_wohnort_nebenjob,mj_arbeitsort_insgesamt,mj_arbeitsort_ausschliesslich,mj_arbeitsort_nebenjob,mj_wohnort_insgesamt_prozent,mj_wohnort_ausschliesslich_prozent,mj_wohnort_nebenjob_prozent,mj_arbeitsort_insgesamt_prozent,mj_arbeitsort_ausschliesslich_prozent,mj_arbeitsort_nebenjob_prozent
14511000,"Chemnitz, Stadt",14,Sachsen,248645,122748,125897,13883,10546,3337,16014,12002,4012,5.6,4.2,1.3,6.4,4.8,1.6
14521010,Amtsberg,14,Sachsen,3779,1866,1913,205,157,48,113,94,19,5.4,4.2,1.3,3.0,2.5,0.5
14521020,"Annaberg-Buchholz, Stadt",14,Sachsen,20426,9776,10650,1129,873,256,1919,1448,471,5.5,4.3,1.3,9.4,7.1,2.3
14521030,"Aue, Stadt",14,Sachsen,16349,7794,8555,856,657,199,1647,1252,395,5.2,4.0,1.2,10.1,7.7,2.4
14521050,Bad Schlema,14,Sachsen,4848,2388,2460,282,219,63,251,201,50,5.8,4.5,1.3,5.2,4.1,1.0
14521110,Breitenbrunn/Erzgeb.,14,Sachsen,5491,2645,2846,307,221,86,195,148,47,5.6,4.0,1.6,3.6,2.7,0.9
14521130,Crottendorf,14,Sachsen,4065,2003,2062,209,149,60,195,139,56,5.1,3.7,1.5,4.8,3.4,1.4
14521150,Drebach,14,Sachsen,5323,2736,2587,263,183,80,232,164,68,4.9,3.4,1.5,4.4,3.1,1.3
14521160,"Ehrenfriedersdorf, Stadt",14,Sachsen,4805,2322,2483,250,191,59,215,168,47,5.2,4.0,1.2,4.5,3.5,1.0
14521170,"Eibenstock, Stadt",14,Sachsen,7640,3791,3849,443,353,90,329,265,64,5.8,4.6,1.2,4.3,3.5,0.8
14521200,Gelenau/Erzgeb.,14,Sachsen,4271,2103,2168,225,173,52,156,120,36,5.3,4.1,1.2,3.7,2.8,0.8
14521240,Großolbersdorf,14,Sachsen,2892,1446,1446,130,87,43,82,54,28,4.5,3.0,1.5,2.8,1.9,1.0
14521250,Großrückerswalde,14,Sachsen,3466,1783,1683,155,112,43,90,69,21,4.5,3.2,1.2,2.6,2.0,0.6
14521260,"Grünhain-Beierfeld, Stadt",14,Sachsen,6021,2998,3023,338,248,90,272,222,50,5.6,4.1,1.5,4.5,3.7,0.8
14521290,Hohndorf,14,Sachsen,3731,1793,1938,204,142,62,103,79,24,5.5,3.8,1.7,2.8,2.1,0.6
14521310,Jahnsdorf/Erzgeb.,14,Sachsen,5530,2766,2764,306,224,82,250,185,65,5.5,4.1,1.5,4.5,3.3,1.2
14521320,"Johanngeorgenstadt, Stadt",14,Sachsen,4135,1990,2145,292,205,87,264,162,102,7.1,5.0,2.1,6.4,3.9,2.5
14521330,"Jöhstadt, Stadt",14,Sachsen,2808,1436,1372,129,99,30,118,71,47,4.6,3.5,1.1,4.2,2.5,1.7
14521355,"Lauter-Bernsbach, Stadt",14,Sachsen,8877,4301,4576,443,329,114,325,249,76,5.0,3.7,1.3,3.7,2.8,0.9
14521370,"Lößnitz, Stadt",14,Sachsen,8677,4235,4442,461,340,121,321,244,77,5.3,3.9,1.4,3.7,2.8,0.9
14521390,"Marienberg, Stadt",14,Sachsen,17409,8676,8733,942,689,253,862,621,241,5.4,4.0,1.5,5.0,3.6,1.4
14521400,Mildenau,14,Sachsen,3396,1693,1703,157,111,46,73,49,24,4.6,3.3,1.4,2.1,1.4,0.7
14521410,Neukirchen/Erzgeb.,14,Sachsen,6805,3361,3444,368,265,103,384,275,109,5.4,3.9,1.5,5.6,4.0,1.6
14521440,"Oberwiesenthal, Kurort, Stadt",14,Sachsen,2194,1067,1127,143,113,30,196,162,34,6.5,5.2,1.4,8.9,7.4,1.5
14521450,"Oelsnitz/Erzgeb., Stadt",14,Sachsen,11117,5355,5762,528,398,130,440,317,123,4.7,3.6,1.2,4.0,2.9,1.1
14521460,"Olbernhau, Stadt",14,Sachsen,9233,4520,4713,596,444,152,521,377,144,6.5,4.8,1.6,5.6,4.1,1.6
14521470,Pfaffroda,14,Sachsen,2471,1246,1225,142,95,47,92,64,28,5.7,3.8,1.9,3.7,2.6,1.1
14521495,"Pockau-Lengefeld, Stadt",14,Sachsen,7853,3900,3953,463,352,111,330,261,69,5.9,4.5,1.4,4.2,3.3,0.9
14521500,Raschau-Markersbach,14,Sachsen,5209,2552,2657,314,238,76,207,166,41,6.0,4.6,1.5,4.0,3.2,0.8
14521530,"Schneeberg, Stadt",14,Sachsen,14732,7246,7486,759,582,177,639,512,127,5.2,4.0,1.2,4.3,3.5,0.9
14521540,Schönheide,14,Sachsen,4568,2242,2326,221,171,50,163,122,41,4.8,3.7,1.1,3.6,2.7,0.9
14521550,"Schwarzenberg/Erzgeb., Stadt",14,Sachsen,17391,8306,9085,957,747,210,955,710,245,5.5,4.3,1.2,5.5,4.1,1.4
14521560,Sehmatal,14,Sachsen,6514,3238,3276,317,237,80,305,228,77,4.9,3.6,1.2,4.7,3.5,1.2
14521600,Stützengrün,14,Sachsen,3341,1655,1686,159,118,41,155,121,34,4.8,3.5,1.2,4.6,3.6,1.0
14521620,"Thalheim/Erzgeb., Stadt",14,Sachsen,6457,3155,3302,388,296,92,285,214,71,6.0,4.6,1.4,4.4,3.3,1.1
14521630,Thermalbad Wiesenbad,14,Sachsen,3366,1671,1695,169,124,45,117,78,39,5.0,3.7,1.3,3.5,2.3,1.2
14521640,"Thum, Stadt",14,Sachsen,5303,2634,2669,283,208,75,174,126,48,5.3,3.9,1.4,3.3,2.4,0.9
14521670,"Wolkenstein, Stadt",14,Sachsen,3905,1918,1987,178,130,48,173,127,46,4.6,3.3,1.2,4.4,3.3,1.2
14521060,Bärenstein,14,Sachsen,2415,1200,1215,135,108,27,105,82,23,5.6,4.5,1.1,4.3,3.4,1.0
14521340,Königswalde,14,Sachsen,2274,1114,1160,129,90,39,71,50,21,5.7,4.0,1.7,3.1,2.2,0.9
14521040,Auerbach,14,Sachsen,2569,1243,1326,127,95,32,80,57,23,4.9,3.7,1.2,3.1,2.2,0.9
14521120,Burkhardtsdorf,14,Sachsen,6210,3086,3124,335,242,93,235,168,67,5.4,3.9,1.5,3.8,2.7,1.1
14521230,Gornsdorf,14,Sachsen,1994,1007,987,89,57,32,91,63,28,4.5,2.9,1.6,4.6,3.2,1.4
14521210,"Geyer, Stadt",14,Sachsen,3582,1741,1841,196,138,58,290,212,78,5.5,3.9,1.6,8.1,5.9,2.2
14521610,Tannenberg,14,Sachsen,1132,561,571,55,42,13,26,22,4,4.9,3.7,1.1,2.3,1.9,0.4
14521380,"Lugau/Erzgeb., Stadt",14,Sachsen,8231,4013,4218,411,311,100,254,186,68,5.0,3.8,1.2,3.1,2.3,0.8
14521430,Niederwürschnitz,14,Sachsen,2643,1295,1348,140,92,48,102,72,30,5.3,3.5,1.8,3.9,2.7,1.1
14521510,"Scheibenberg, Stadt",14,Sachsen,2175,1088,1087,137,107,30,129,98,31,6.3,4.9,1.4,5.9,4.5,1.4
14521520,"Schlettau, Stadt",14,Sachsen,2442,1183,1259,131,103,28,109,85,24,5.4,4.2,1.1,4.5,3.5,1.0
14521140,Deutschneudorf,14,Sachsen,1062,549,513,82,58,24,62,43,19,7.7,5.5,2.3,5.8,4.0,1.8
14521280,Heidersdorf,14,Sachsen,815,423,392,74,52,22,66,39,27,9.1,6.4,2.7,8.1,4.8,3.3
14521570,"Seiffen/Erzgeb., Kurort",14,Sachsen,2305,1163,1142,188,149,39,215,176,39,8.2,6.5,1.7,9.3,7.6,1.7
14521420,Niederdorf,14,Sachsen,1265,640,625,67,51,16,80,59,21,5.3,4.0,1.3,6.3,4.7,1.7
14521590,"Stollberg/Erzgeb., Stadt",14,Sachsen,11380,5505,5875,539,377,162,657,444,213,4.7,3.3,1.4,5.8,3.9,1.9
14521220,Gornau/Erzgeb.,14,Sachsen,3835,1880,1955,180,127,53,163,117,46,4.7,3.3,1.4,4.3,3.1,1.2
14521690,"Zschopau, Stadt",14,Sachsen,9538,4666,4872,526,397,129,553,397,156,5.5,4.2,1.4,5.8,4.2,1.6
14521080,Bockau,14,Sachsen,2322,1140,1182,141,109,32,63,54,9,6.1,4.7,1.4,2.7,2.3,0.4
14521700,Zschorlau,14,Sachsen,5390,2623,2767,283,219,64,148,120,28,5.3,4.1,1.2,2.7,2.2,0.5
14521180,"Elterlein, Stadt",14,Sachsen,2923,1461,1462,168,123,45,123,94,29,5.7,4.2,1.5,4.2,3.2,1.0
14521710,"Zwönitz, Stadt",14,Sachsen,12262,5947,6315,682,501,181,504,381,123,5.6,4.1,1.5,4.1,3.1,1.0
14521090,Börnichen/Erzgeb.,14,Sachsen,984,488,496,62,46,16,43,30,13,6.3,4.7,1.6,4.4,3.0,1.3
14521270,Grünhainichen,14,Sachsen,3519,1741,1778,187,130,57,122,90,32,5.3,3.7,1.6,3.5,2.6,0.9
14522020,"Augustusburg, Stadt",14,Sachsen,4581,2276,2305,258,192,66,181,128,53,5.6,4.2,1.4,4.0,2.8,1.2
14522035,Bobritzsch-Hilbersdorf,14,Sachsen,5801,2888,2913,293,187,106,202,130,72,5.1,3.2,1.8,3.5,2.2,1.2
14522050,"Brand-Erbisdorf, Stadt",14,Sachsen,9785,4783,5002,556,406,150,876,688,188,5.7,4.1,1.5,9.0,7.0,1.9
14522070,Claußnitz,14,Sachsen,3142,1550,1592,147,106,41,84,61,23,4.7,3.4,1.3,2.7,1.9,0.7
14522080,"Döbeln, Stadt",14,Sachsen,21730,10577,11153,1140,841,299,1323,949,374,5.2,3.9,1.4,6.1,4.4,1.7
14522110,Eppendorf,14,Sachsen,4231,2047,2184,248,178,70,164,118,46,5.9,4.2,1.7,3.9,2.8,1.1
14522120,Erlau,14,Sachsen,3256,1659,1597,180,123,57,82,56,26,5.5,3.8,1.8,2.5,1.7,0.8
14522140,"Flöha, Stadt",14,Sachsen,10967,5311,5656,583,456,127,374,291,83,5.3,4.2,1.2,3.4,2.7,0.8
14522150,"Frankenberg/Sa., Stadt",14,Sachsen,14462,7170,7292,682,472,210,463,326,137,4.7,3.3,1.5,3.2,2.3,0.9
14522170,"Frauenstein, Stadt",14,Sachsen,2936,1489,1447,175,122,53,146,98,48,6.0,4.2,1.8,5.0,3.3,1.6
14522180,"Freiberg, Stadt, Universitätsstadt",14,Sachsen,41641,20834,20807,2496,1936,560,2794,2130,664,6.0,4.6,1.3,6.7,5.1,1.6
14522190,"Geringswalde, Stadt",14,Sachsen,4331,2123,2208,232,172,60,187,137,50,5.4,4.0,1.4,4.3,3.2,1.2
14522200,Großhartmannsdorf,14,Sachsen,2532,1293,1239,144,97,47,78,50,28,5.7,3.8,1.9,3.1,2.0,1.1
14522210,"Großschirma, Stadt",14,Sachsen,5721,2861,2860,267,196,71,274,196,78,4.7,3.4,1.2,4.8,3.4,1.4
14522220,Großweitzschen,14,Sachsen,2806,1422,1384,152,100,52,154,90,64,5.4,3.6,1.9,5.5,3.2,2.3
14522230,"Hainichen, Stadt",14,Sachsen,8711,4335,4376,382,299,83,379,278,101,4.4,3.4,1.0,4.4,3.2,1.2
14522240,Halsbrücke,14,Sachsen,5190,2577,2613,220,152,68,182,132,50,4.2,2.9,1.3,3.5,2.5,1.0
14522250,"Hartha, Stadt",14,Sachsen,7231,3532,3699,377,270,107,288,205,83,5.2,3.7,1.5,4.0,2.8,1.1
14522260,Hartmannsdorf,14,Sachsen,4417,2149,2268,228,164,64,278,222,56,5.2,3.7,1.4,6.3,5.0,1.3
14522290,Königshain-Wiederau,14,Sachsen,2712,1407,1305,120,76,44,78,57,21,4.4,2.8,1.6,2.9,2.1,0.8
14522300,Kriebstein,14,Sachsen,2164,1072,1092,100,65,35,96,74,22,4.6,3.0,1.6,4.4,3.4,1.0
14522310,"Leisnig, Stadt",14,Sachsen,8386,4080,4306,449,320,129,332,250,82,5.4,3.8,1.5,4.0,3.0,1.0
14522320,Leubsdorf,14,Sachsen,3406,1714,1692,175,119,56,128,96,32,5.1,3.5,1.6,3.8,2.8,0.9
14522330,Lichtenau,14,Sachsen,7236,3603,3633,365,244,121,259,172,87,5.0,3.4,1.7,3.6,2.4,1.2
14522350,"Lunzenau, Stadt",14,Sachsen,4376,2139,2237,207,162,45,129,101,28,4.7,3.7,1.0,2.9,2.3,0.6
14522370,Mochau,14,Sachsen,2304,1189,1115,109,74,35,70,50,20,4.7,3.2,1.5,3.0,2.2,0.9
14522390,Mulda/Sa.,14,Sachsen,2557,1284,1273,149,109,40,94,69,25,5.8,4.3,1.6,3.7,2.7,1.0
14522400,Neuhausen/Erzgeb.,14,Sachsen,2678,1364,1314,173,137,36,146,110,36,6.5,5.1,1.3,5.5,4.1,1.3
14522420,Niederwiesa,14,Sachsen,4909,2433,2476,246,174,72,199,144,55,5.0,3.5,1.5,4.1,2.9,1.1
14522430,Oberschöna,14,Sachsen,3346,1698,1648,159,110,49,114,75,39,4.8,3.3,1.5,3.4,2.2,1.2
14522440,"Oederan, Stadt",14,Sachsen,8172,4041,4131,462,320,142,399,293,106,5.7,3.9,1.7,4.9,3.6,1.3
14522460,"Penig, Stadt",14,Sachsen,9036,4416,4620,463,368,95,333,264,69,5.1,4.1,1.1,3.7,2.9,0.8
14522470,Rechenberg-Bienenmühle,14,Sachsen,1941,980,961,114,89,25,117,88,29,5.9,4.6,1.3,6.0,4.5,1.5
14522480,Reinsberg,14,Sachsen,2954,1508,1446,159,118,41,84,61,23,5.4,4.0,1.4,2.8,2.1,0.8
14522500,Rossau,14,Sachsen,3598,1819,1779,163,111,52,133,88,45,4.5,3.1,1.4,3.7,2.4,1.3
14522510,"Roßwein, Stadt",14,Sachsen,7672,3870,3802,412,310,102,257,187,70,5.4,4.0,1.3,3.3,2.4,0.9
14522540,Striegistal,14,Sachsen,4842,2490,2352,224,167,57,98,71,27,4.6,3.4,1.2,2.0,1.5,0.6
14522570,"Waldheim, Stadt",14,Sachsen,9082,4632,4450,469,353,116,322,244,78,5.2,3.9,1.3,3.5,2.7,0.9
14522580,Wechselburg,14,Sachsen,1884,949,935,96,73,23,51,34,17,5.1,3.9,1.2,2.7,1.8,0.9
14522060,"Burgstädt, Stadt",14,Sachsen,10774,5205,5569,647,498,149,593,446,147,6.0,4.6,1.4,5.5,4.1,1.4
14522380,Mühlau,14,Sachsen,2113,1062,1051,93,65,28,152,118,34,4.4,3.1,1.3,7.2,5.6,1.6
14522550,Taura,14,Sachsen,2419,1177,1242,140,98,42,60,49,11,5.8,4.1,1.7,2.5,2.0,0.5
14522340,Lichtenberg/Erzgeb.,14,Sachsen,2709,1311,1398,144,89,55,95,61,34,5.3,3.3,2.0,3.5,2.3,1.3
14522590,Weißenborn/Erzgeb.,14,Sachsen,2528,1292,1236,144,107,37,106,73,33,5.7,4.2,1.5,4.2,2.9,1.3
14522010,Altmittweida,14,Sachsen,1932,951,981,98,68,30,85,61,24,5.1,3.5,1.6,4.4,3.2,1.2
14522360,"Mittweida, Stadt, Hochschulstadt",14,Sachsen,14939,7438,7501,930,713,217,1403,1093,310,6.2,4.8,1.5,9.4,7.3,2.1
14522450,Ostrau,14,Sachsen,3603,1817,1786,174,129,45,162,134,28,4.8,3.6,1.2,4.5,3.7,0.8
14522620,Zschaitz-Ottewig,14,Sachsen,1322,673,649,53,36,17,29,15,14,4.0,2.7,1.3,2.2,1.1,1.1
14522280,Königsfeld,14,Sachsen,1492,766,726,59,37,22,29,20,9,4.0,2.5,1.5,1.9,1.3,0.6
14522490,"Rochlitz, Stadt",14,Sachsen,5905,2817,3088,297,235,62,294,219,75,5.0,4.0,1.0,5.0,3.7,1.3
14522530,Seelitz,14,Sachsen,1773,889,884,82,59,23,33,23,10,4.6,3.3,1.3,1.9,1.3,0.6
14522600,Zettlitz,14,Sachsen,737,380,357,28,22,6,19,16,3,3.8,3.0,0.8,2.6,2.2,0.4
14522090,Dorfchemnitz,14,Sachsen,1565,797,768,84,60,24,73,51,22,5.4,3.8,1.5,4.7,3.3,1.4
14522520,"Sayda, Stadt",14,Sachsen,1913,945,968,101,78,23,87,70,17,5.3,4.1,1.2,4.5,3.7,0.9
14523010,"Adorf/Vogtl., Stadt",14,Sachsen,5078,2445,2633,259,194,65,225,153,72,5.1,3.8,1.3,4.4,3.0,1.4
14523020,"Auerbach/Vogtl., Stadt",14,Sachsen,18893,9054,9839,1028,752,276,1128,820,308,5.4,4.0,1.5,6.0,4.3,1.6
14523030,Bad Brambach,14,Sachsen,1941,927,1014,101,75,26,81,62,19,5.2,3.9,1.3,4.2,3.2,1.0
14523040,"Bad Elster, Stadt",14,Sachsen,3692,1762,1930,223,157,66,246,165,81,6.0,4.3,1.8,6.7,4.5,2.2
14523090,Ellefeld,14,Sachsen,2578,1244,1334,113,72,41,157,111,46,4.4,2.8,1.6,6.1,4.3,1.8
14523100,"Elsterberg, Stadt",14,Sachsen,4188,2061,2127,207,160,47,125,95,30,4.9,3.8,1.1,3.0,2.3,0.7
14523160,"Klingenthal, Stadt",14,Sachsen,8783,4255,4528,538,390,148,462,343,119,6.1,4.4,1.7,5.3,3.9,1.4
14523170,"Lengenfeld, Stadt",14,Sachsen,7225,3562,3663,371,281,90,311,244,67,5.1,3.9,1.2,4.3,3.4,0.9
14523200,"Markneukirchen, Stadt",14,Sachsen,7782,3804,3978,463,324,139,371,272,99,5.9,4.2,1.8,4.8,3.5,1.3
14523245,Muldenhammer,14,Sachsen,3167,1582,1585,152,111,41,98,72,26,4.8,3.5,1.3,3.1,2.3,0.8
14523250,"Mylau, Stadt",14,Sachsen,2520,1274,1246,161,109,52,133,105,28,6.4,4.3,2.1,5.3,4.2,1.1
14523280,Neumark,14,Sachsen,2988,1508,1480,159,116,43,143,101,42,5.3,3.9,1.4,4.8,3.4,1.4
14523310,"Pausa-Mühltroff, Stadt",14,Sachsen,5101,2516,2585,275,212,63,232,178,54,5.4,4.2,1.2,4.5,3.5,1.1
14523320,"Plauen, Stadt",14,Sachsen,65201,31764,33437,3502,2480,1022,3729,2626,1103,5.4,3.8,1.6,5.7,4.0,1.7
14523330,Pöhl,14,Sachsen,2540,1248,1292,150,92,58,115,78,37,5.9,3.6,2.3,4.5,3.1,1.5
14523360,"Rodewisch, Stadt",14,Sachsen,6434,3151,3283,362,271,91,374,249,125,5.6,4.2,1.4,5.8,3.9,1.9
14523365,Rosenbach/Vogtl.,14,Sachsen,4304,2132,2172,242,170,72,175,122,53,5.6,3.9,1.7,4.1,2.8,1.2
14523380,Steinberg,14,Sachsen,2835,1372,1463,141,100,41,145,107,38,5.0,3.5,1.4,5.1,3.8,1.3
14523120,"Falkenstein/Vogtl., Stadt",14,Sachsen,8300,3937,4363,437,306,131,401,299,102,5.3,3.7,1.6,4.8,3.6,1.2
14523130,Grünbach,14,Sachsen,1766,866,900,85,58,27,84,67,17,4.8,3.3,1.5,4.8,3.8,1.0
14523290,Neustadt/Vogtl.,14,Sachsen,979,488,491,49,38,11,22,14,8,5.0,3.9,1.1,2.2,1.4,0.8
14523190,Limbach,14,Sachsen,1465,715,750,96,63,33,46,28,18,6.6,4.3,2.3,3.1,1.9,1.2
14523260,"Netzschkau, Stadt",14,Sachsen,4041,1946,2095,207,152,55,181,130,51,5.1,3.8,1.4,4.5,3.2,1.3
14523060,Bösenbrunn,14,Sachsen,1184,575,609,61,40,21,25,15,10,5.2,3.4,1.8,2.1,1.3,0.8
14523080,Eichigt,14,Sachsen,1217,635,582,71,48,23,32,23,9,5.8,3.9,1.9,2.6,1.9,0.7
14523300,"Oelsnitz/Vogtl., Stadt",14,Sachsen,10492,5114,5378,551,381,170,516,348,168,5.3,3.6,1.6,4.9,3.3,1.6
14523440,Triebel/Vogtl.,14,Sachsen,1261,635,626,62,41,21,25,19,6,4.9,3.3,1.7,2.0,1.5,0.5
14523150,Heinsdorfergrund,14,Sachsen,2039,993,1046,122,92,30,143,102,41,6.0,4.5,1.5,7.0,5.0,2.0
14523340,"Reichenbach im Vogtland, Stadt",14,Sachsen,18680,8941,9739,940,687,253,831,614,217,5.0,3.7,1.4,4.4,3.3,1.2
14523230,Mühlental,14,Sachsen,1338,689,649,58,36,22,31,24,7,4.3,2.7,1.6,2.3,1.8,0.5
14523370,"Schöneck/Vogtl., Stadt",14,Sachsen,3221,1560,1661,143,91,52,143,100,43,4.4,2.8,1.6,4.4,3.1,1.3
14523270,Neuensalz,14,Sachsen,2172,1079,1093,113,80,33,78,48,30,5.2,3.7,1.5,3.6,2.2,1.4
14523430,"Treuen, Stadt",14,Sachsen,8037,3933,4104,413,285,128,352,254,98,5.1,3.5,1.6,4.4,3.2,1.2
14523350,Reuth,14,Sachsen,985,497,488,50,36,14,41,28,13,5.1,3.7,1.4,4.2,2.8,1.3
14523450,Weischlitz,14,Sachsen,5000,2474,2526,264,186,78,173,114,59,5.3,3.7,1.6,3.5,2.3,1.2
14523050,Bergen,14,Sachsen,971,483,488,41,29,12,16,11,5,4.2,3.0,1.2,1.6,1.1,0.5
14523410,Theuma,14,Sachsen,1039,532,507,47,28,19,40,26,14,4.5,2.7,1.8,3.8,2.5,1.3
14523420,Tirpersdorf,14,Sachsen,1401,691,710,63,46,17,46,30,16,4.5,3.3,1.2,3.3,2.1,1.1
14523460,Werda,14,Sachsen,1480,730,750,64,40,24,40,28,12,4.3,2.7,1.6,2.7,1.9,0.8
14524020,Callenberg,14,Sachsen,5078,2541,2537,280,202,78,173,116,57,5.5,4.0,1.5,3.4,2.3,1.1
14524060,Fraureuth,14,Sachsen,5212,2515,2697,261,199,62,208,168,40,5.0,3.8,1.2,4.0,3.2,0.8
14524070,Gersdorf,14,Sachsen,4071,1990,2081,212,146,66,145,108,37,5.2,3.6,1.6,3.6,2.7,0.9
14524080,"Glauchau, Stadt",14,Sachsen,23255,11431,11824,1177,855,322,1542,1184,358,5.1,3.7,1.4,6.6,5.1,1.5
14524090,"Hartenstein, Stadt",14,Sachsen,4669,2271,2398,233,167,66,147,100,47,5.0,3.6,1.4,3.1,2.1,1.0
14524120,"Hohenstein-Ernstthal, Stadt",14,Sachsen,14866,7136,7730,977,731,246,1017,743,274,6.6,4.9,1.7,6.8,5.0,1.8
14524140,Langenbernsdorf,14,Sachsen,3553,1799,1754,162,115,47,132,89,43,4.6,3.2,1.3,3.7,2.5,1.2
14524150,Langenweißbach,14,Sachsen,2531,1256,1275,122,81,41,35,27,8,4.8,3.2,1.6,1.4,1.1,0.3
14524170,Lichtentanne,14,Sachsen,6546,3130,3416,325,232,93,284,187,97,5.0,3.5,1.4,4.3,2.9,1.5
14524200,Mülsen,14,Sachsen,11526,5655,5871,594,442,152,373,263,110,5.2,3.8,1.3,3.2,2.3,1.0
14524210,Neukirchen/Pleiße,14,Sachsen,3996,1955,2041,229,175,54,206,167,39,5.7,4.4,1.4,5.2,4.2,1.0
14524230,"Oberlungwitz, Stadt",14,Sachsen,5928,2880,3048,344,246,98,412,315,97,5.8,4.1,1.7,7.0,5.3,1.6
14524250,Reinsdorf,14,Sachsen,7599,3729,3870,380,268,112,231,165,66,5.0,3.5,1.5,3.0,2.2,0.9
14524300,"Werdau, Stadt",14,Sachsen,21039,10312,10727,1251,929,322,1145,856,289,5.9,4.4,1.5,5.4,4.1,1.4
14524310,"Wildenfels, Stadt",14,Sachsen,3709,1857,1852,181,126,55,156,109,47,4.9,3.4,1.5,4.2,2.9,1.3
14524320,"Wilkau-Haßlau, Stadt",14,Sachsen,10281,4874,5407,523,390,133,454,356,98,5.1,3.8,1.3,4.4,3.5,1.0
14524330,"Zwickau, Stadt",14,Sachsen,91123,44491,46632,4922,3618,1304,6616,4903,1713,5.4,4.0,1.4,7.3,5.4,1.9
14524030,"Crimmitschau, Stadt",14,Sachsen,19180,9243,9937,1154,857,297,971,701,270,6.0,4.5,1.5,5.1,3.7,1.4
14524050,Dennheritz,14,Sachsen,1322,673,649,65,44,21,41,31,10,4.9,3.3,1.6,3.1,2.3,0.8
14524040,Crinitzberg,14,Sachsen,1977,977,1000,102,75,27,53,40,13,5.2,3.8,1.4,2.7,2.0,0.7
14524100,Hartmannsdorf b. Kirchberg,14,Sachsen,1350,649,701,79,56,23,55,35,20,5.9,4.1,1.7,4.1,2.6,1.5
14524110,Hirschfeld,14,Sachsen,1184,592,592,75,48,27,60,43,17,6.3,4.1,2.3,5.1,3.6,1.4
14524130,"Kirchberg, Stadt",14,Sachsen,8505,4065,4440,465,352,113,325,257,68,5.5,4.1,1.3,3.8,3.0,0.8
14524180,"Limbach-Oberfrohna, Stadt",14,Sachsen,24059,11672,12387,1361,1011,350,1213,902,311,5.7,4.2,1.5,5.0,3.7,1.3
14524220,Niederfrohna,14,Sachsen,2231,1120,1111,108,83,25,54,42,12,4.8,3.7,1.1,2.4,1.9,0.5
14524190,"Meerane, Stadt",14,Sachsen,14851,7125,7726,761,559,202,651,469,182,5.1,3.8,1.4,4.4,3.2,1.2
14524270,Schönberg,14,Sachsen,942,473,469,37,22,15,32,18,14,3.9,2.3,1.6,3.4,1.9,1.5
14524010,Bernsdorf,14,Sachsen,2224,1118,1106,112,86,26,129,83,46,5.0,3.9,1.2,5.8,3.7,2.1
14524160,"Lichtenstein/Sa., Stadt",14,Sachsen,11632,5562,6070,607,461,146,981,648,333,5.2,4.0,1.3,8.4,5.6,2.9
14524280,St. Egidien,14,Sachsen,3302,1618,1684,163,116,47,163,118,45,4.9,3.5,1.4,4.9,3.6,1.4
14524240,Oberwiera,14,Sachsen,1038,515,523,71,50,21,50,32,18,6.8,4.8,2.0,4.8,3.1,1.7
14524260,Remse,14,Sachsen,1651,817,834,90,69,21,45,32,13,5.5,4.2,1.3,2.7,1.9,0.8
14524290,"Waldenburg, Stadt",14,Sachsen,4104,2026,2078,189,133,56,158,118,40,4.6,3.2,1.4,3.8,2.9,1.0
14612000,"Dresden, Stadt",14,Sachsen,543825,270410,273415,30056,22338,7718,33023,23928,9095,5.5,4.1,1.4,6.1,4.4,1.7
14625010,Arnsdorf,14,Sachsen,4760,2465,2295,183,124,59,137,96,41,3.8,2.6,1.2,2.9,2.0,0.9
14625020,"Bautzen, Stadt",14,Sachsen,39845,19325,20520,2084,1616,468,3765,2973,792,5.2,4.1,1.2,9.4,7.5,2.0
14625030,"Bernsdorf, Stadt",14,Sachsen,6584,3231,3353,275,230,45,177,143,34,4.2,3.5,0.7,2.7,2.2,0.5
14625060,Burkau,14,Sachsen,2665,1375,1290,120,95,25,69,51,18,4.5,3.6,0.9,2.6,1.9,0.7
14625090,Cunewalde,14,Sachsen,4781,2354,2427,238,185,53,186,138,48,5.0,3.9,1.1,3.9,2.9,1.0
14625100,Demitz-Thumitz,14,Sachsen,2704,1354,1350,137,99,38,78,58,20,5.1,3.7,1.4,2.9,2.1,0.7
14625110,Doberschau-Gaußig,14,Sachsen,4228,2147,2081,224,165,59,129,101,28,5.3,3.9,1.4,3.1,2.4,0.7
14625120,Elsterheide,14,Sachsen,3544,1775,1769,185,126,59,1376,1044,332,5.2,3.6,1.7,38.8,29.5,9.4
14625130,"Elstra, Stadt",14,Sachsen,2840,1427,1413,130,89,41,70,51,19,4.6,3.1,1.4,2.5,1.8,0.7
14625150,Göda,14,Sachsen,3084,1552,1532,156,111,45,102,80,22,5.1,3.6,1.5,3.3,2.6,0.7
14625160,Großdubrau,14,Sachsen,4239,2120,2119,230,181,49,145,116,29,5.4,4.3,1.2,3.4,2.7,0.7
14625220,Haselbachtal,14,Sachsen,4073,2066,2007,195,149,46,115,86,29,4.8,3.7,1.1,2.8,2.1,0.7
14625230,Hochkirch,14,Sachsen,2322,1173,1149,114,89,25,63,44,19,4.9,3.8,1.1,2.7,1.9,0.8
14625240,"Hoyerswerda, Stadt",14,Sachsen,33843,16296,17547,1659,1335,324,1711,1359,352,4.9,3.9,1.0,5.1,4.0,1.0
14625280,Königswartha,14,Sachsen,3511,1754,1757,225,165,60,177,128,49,6.4,4.7,1.7,5.0,3.6,1.4
14625290,Kubschütz,14,Sachsen,2579,1318,1261,140,100,40,83,64,19,5.4,3.9,1.6,3.2,2.5,0.7
14625310,"Lauta, Stadt",14,Sachsen,8590,4205,4385,442,358,84,246,202,44,5.1,4.2,1.0,2.9,2.4,0.5
14625330,Lohsa,14,Sachsen,5393,2653,2740,243,186,57,128,102,26,4.5,3.4,1.1,2.4,1.9,0.5
14625340,Malschwitz,14,Sachsen,4903,2492,2411,256,182,74,210,153,57,5.2,3.7,1.5,4.3,3.1,1.2
14625380,Neukirch/Lausitz,14,Sachsen,5066,2511,2555,289,219,70,198,155,43,5.7,4.3,1.4,3.9,3.1,0.8
14625420,Oßling,14,Sachsen,2322,1211,1111,92,70,22,58,43,15,4.0,3.0,0.9,2.5,1.9,0.6
14625430,Ottendorf-Okrilla,14,Sachsen,9941,4954,4987,492,332,160,439,321,118,4.9,3.3,1.6,4.4,3.2,1.2
14625480,"Radeberg, Stadt",14,Sachsen,18389,9013,9376,791,544,247,1826,1430,396,4.3,3.0,1.3,9.9,7.8,2.2
14625490,Radibor,14,Sachsen,3166,1604,1562,164,113,51,76,62,14,5.2,3.6,1.6,2.4,2.0,0.4
14625525,"Schirgiswalde-Kirschau, Stadt",14,Sachsen,6399,3214,3185,361,282,79,271,202,69,5.6,4.4,1.2,4.2,3.2,1.1
14625530,Schmölln-Putzkau,14,Sachsen,3029,1507,1522,133,105,28,93,64,29,4.4,3.5,0.9,3.1,2.1,1.0
14625550,Schwepnitz,14,Sachsen,2527,1295,1232,127,93,34,71,50,21,5.0,3.7,1.3,2.8,2.0,0.8
14625560,Sohland a. d. Spree,14,Sachsen,6876,3400,3476,346,277,69,273,222,51,5.0,4.0,1.0,4.0,3.2,0.7
14625570,Spreetal,14,Sachsen,1931,966,965,83,58,25,34,26,8,4.3,3.0,1.3,1.8,1.3,0.4
14625590,Steinigtwolmsdorf,14,Sachsen,2943,1488,1455,154,115,39,87,59,28,5.2,3.9,1.3,3.0,2.0,1.0
14625600,Wachau,14,Sachsen,4333,2222,2111,178,115,63,129,91,38,4.1,2.7,1.5,3.0,2.1,0.9
14625610,"Weißenberg, Stadt",14,Sachsen,3183,1646,1537,163,111,52,113,85,28,5.1,3.5,1.6,3.6,2.7,0.9
14625630,"Wilthen, Stadt",14,Sachsen,5091,2447,2644,252,199,53,254,199,55,4.9,3.9,1.0,5.0,3.9,1.1
14625640,"Wittichenau, Stadt",14,Sachsen,5800,2841,2959,279,195,84,193,140,53,4.8,3.4,1.4,3.3,2.4,0.9
14625040,"Bischofswerda, Stadt",14,Sachsen,11573,5615,5958,653,486,167,759,579,180,5.6,4.2,1.4,6.6,5.0,1.6
14625510,Rammenau,14,Sachsen,1400,696,704,78,58,20,56,37,19,5.6,4.1,1.4,4.0,2.6,1.4
14625140,Frankenthal,14,Sachsen,950,477,473,51,35,16,34,25,9,5.4,3.7,1.7,3.6,2.6,0.9
14625170,Großharthau,14,Sachsen,2717,1341,1376,128,95,33,90,59,31,4.7,3.5,1.2,3.3,2.2,1.1
14625190,Großpostwitz/O.L.,14,Sachsen,2716,1340,1376,139,106,33,101,72,29,5.1,3.9,1.2,3.7,2.7,1.1
14625390,Obergurig,14,Sachsen,2096,1050,1046,88,66,22,84,48,36,4.2,3.1,1.0,4.0,2.3,1.7
14625050,Bretnig-Hauswalde,14,Sachsen,2914,1444,1470,163,116,47,219,165,54,5.6,4.0,1.6,7.5,5.7,1.9
14625200,"Großröhrsdorf, Stadt",14,Sachsen,6631,3251,3380,355,263,92,284,201,83,5.4,4.0,1.4,4.3,3.0,1.3
14625250,"Kamenz, Stadt",14,Sachsen,15202,7504,7698,785,573,212,908,676,232,5.2,3.8,1.4,6.0,4.4,1.5
14625540,Schönteichen,14,Sachsen,2098,1065,1033,96,68,28,42,35,7,4.6,3.2,1.3,2.0,1.7,0.3
14625270,"Königsbrück, Stadt",14,Sachsen,4429,2168,2261,244,170,74,239,184,55,5.5,3.8,1.7,5.4,4.2,1.2
14625300,Laußnitz,14,Sachsen,1890,957,933,79,57,22,66,36,30,4.2,3.0,1.2,3.5,1.9,1.6
14625370,Neukirch,14,Sachsen,1644,826,818,73,50,23,41,28,13,4.4,3.0,1.4,2.5,1.7,0.8
14625360,Neschwitz,14,Sachsen,2511,1284,1227,121,94,27,59,46,13,4.8,3.7,1.1,2.3,1.8,0.5
14625460,Puschwitz,14,Sachsen,821,405,416,42,29,13,19,12,7,5.1,3.5,1.6,2.3,1.5,0.9
14625180,Großnaundorf,14,Sachsen,981,484,497,46,36,10,23,19,4,4.7,3.7,1.0,2.3,1.9,0.4
14625320,Lichtenberg,14,Sachsen,1595,797,798,65,46,19,26,16,10,4.1,2.9,1.2,1.6,1.0,0.6
14625410,Ohorn,14,Sachsen,2406,1206,1200,148,115,33,72,54,18,6.2,4.8,1.4,3.0,2.2,0.7
14625450,"Pulsnitz, Stadt",14,Sachsen,7488,3645,3843,374,271,103,530,388,142,5.0,3.6,1.4,7.1,5.2,1.9
14625580,Steina,14,Sachsen,1637,829,808,65,45,20,29,18,11,4.0,2.7,1.2,1.8,1.1,0.7
14625080,Crostwitz,14,Sachsen,1017,500,517,56,39,17,19,13,6,5.5,3.8,1.7,1.9,1.3,0.6
14625350,Nebelschütz,14,Sachsen,1157,594,563,50,42,8,37,33,4,4.3,3.6,0.7,3.2,2.9,0.3
14625440,Panschwitz-Kuckau,14,Sachsen,2116,1005,1111,108,69,39,84,57,27,5.1,3.3,1.8,4.0,2.7,1.3
14625470,Räckelwitz,14,Sachsen,1103,547,556,50,33,17,30,21,9,4.5,3.0,1.5,2.7,1.9,0.8
14625500,Ralbitz-Rosenthal,14,Sachsen,1697,918,779,73,41,32,44,24,20,4.3,2.4,1.9,2.6,1.4,1.2
14626060,Boxberg/O.L.,14,Sachsen,4752,2413,2339,212,165,47,138,106,32,4.5,3.5,1.0,2.9,2.2,0.7
14626085,"Ebersbach-Neugersdorf, Stadt",14,Sachsen,12484,6057,6427,625,495,130,558,421,137,5.0,4.0,1.0,4.5,3.4,1.1
14626110,"Görlitz, Stadt",14,Sachsen,55255,26576,28679,2894,2261,633,2806,2201,605,5.2,4.1,1.1,5.1,4.0,1.1
14626180,"Herrnhut, Stadt",14,Sachsen,6097,3021,3076,286,217,69,210,167,43,4.7,3.6,1.1,3.4,2.7,0.7
14626245,Kottmar,14,Sachsen,7515,3684,3831,312,233,79,242,172,70,4.2,3.1,1.1,3.2,2.3,0.9
14626250,Krauschwitz,14,Sachsen,3546,1754,1792,158,118,40,94,75,19,4.5,3.3,1.1,2.7,2.1,0.5
14626280,Leutersdorf,14,Sachsen,3655,1818,1837,157,120,37,94,70,24,4.3,3.3,1.0,2.6,1.9,0.7
14626300,Markersdorf,14,Sachsen,3986,2051,1935,203,140,63,151,95,56,5.1,3.5,1.6,3.8,2.4,1.4
14626310,Mittelherwigsdorf,14,Sachsen,3620,1850,1770,173,136,37,111,87,24,4.8,3.8,1.0,3.1,2.4,0.7
14626370,"Niesky, Stadt",14,Sachsen,9607,4721,4886,528,395,133,546,399,147,5.5,4.1,1.4,5.7,4.2,1.5
14626390,Oderwitz,14,Sachsen,5203,2513,2690,203,165,38,150,119,31,3.9,3.2,0.7,2.9,2.3,0.6
14626420,"Ostritz, Stadt",14,Sachsen,2382,1163,1219,105,83,22,72,57,15,4.4,3.5,0.9,3.0,2.4,0.6
14626530,"Seifhennersdorf, Stadt",14,Sachsen,3817,1884,1933,171,129,42,139,111,28,4.5,3.4,1.1,3.6,2.9,0.7
14626610,"Zittau, Stadt",14,Sachsen,25712,12418,13294,1447,1152,295,1543,1214,329,5.6,4.5,1.1,6.0,4.7,1.3
14626010,"Bad Muskau, Stadt",14,Sachsen,3646,1765,1881,174,135,39,174,135,39,4.8,3.7,1.1,4.8,3.7,1.1
14626100,Gablenz,14,Sachsen,1619,812,807,84,64,20,52,39,13,5.2,4.0,1.2,3.2,2.4,0.8
14626030,"Bernstadt a. d. Eigen, Stadt",14,Sachsen,3425,1694,1731,162,121,41,94,71,23,4.7,3.5,1.2,2.7,2.1,0.7
14626500,Schönau-Berzdorf a. d. Eigen,14,Sachsen,1476,750,726,78,59,19,82,46,36,5.3,4.0,1.3,5.6,3.1,2.4
14626140,Großschönau,14,Sachsen,5589,2696,2893,293,238,55,404,338,66,5.2,4.3,1.0,7.2,6.0,1.2
14626170,Hainewalde,14,Sachsen,1526,765,761,78,59,19,38,31,7,5.1,3.9,1.2,2.5,2.0,0.5
14626150,Großschweidnitz,14,Sachsen,1345,705,640,43,28,15,25,17,8,3.2,2.1,1.1,1.9,1.3,0.6
14626270,Lawalde,14,Sachsen,1916,935,981,97,66,31,80,53,27,5.1,3.4,1.6,4.2,2.8,1.4
14626290,"Löbau, Stadt",14,Sachsen,15353,7500,7853,832,646,186,1018,804,214,5.4,4.2,1.2,6.6,5.2,1.4
14626470,Rosenbach,14,Sachsen,1634,824,810,83,50,33,42,32,10,5.1,3.1,2.0,2.6,2.0,0.6
14626070,Dürrhennersdorf,14,Sachsen,1006,508,498,48,39,9,34,26,8,4.8,3.9,0.9,3.4,2.6,0.8
14626350,"Neusalza-Spremberg, Stadt",14,Sachsen,3356,1656,1700,192,155,37,146,114,32,5.7,4.6,1.1,4.4,3.4,1.0
14626510,Schönbach,14,Sachsen,1133,578,555,45,34,11,42,38,4,4.0,3.0,1.0,3.7,3.4,0.4
14626050,Bertsdorf-Hörnitz,14,Sachsen,2145,1093,1052,113,85,28,47,37,10,5.3,4.0,1.3,2.2,1.7,0.5
14626210,"Jonsdorf, Kurort",14,Sachsen,1583,759,824,103,81,22,85,68,17,6.5,5.1,1.4,5.4,4.3,1.1
14626400,Olbersdorf,14,Sachsen,5055,2431,2624,262,211,51,131,104,27,5.2,4.2,1.0,2.6,2.1,0.5
14626430,Oybin,14,Sachsen,1418,692,726,83,58,25,65,51,14,5.9,4.1,1.8,4.6,3.6,1.0
14626020,Beiersdorf,14,Sachsen,1135,577,558,52,41,11,37,23,14,4.6,3.6,1.0,3.3,2.0,1.2
14626410,Oppach,14,Sachsen,2424,1178,1246,126,101,25,100,81,19,5.2,4.2,1.0,4.1,3.3,0.8
14626240,Königshain,14,Sachsen,1177,593,584,74,48,26,52,42,10,6.3,4.1,2.2,4.4,3.6,0.8
14626450,"Reichenbach/O.L., Stadt",14,Sachsen,5078,2519,2559,254,189,65,217,161,56,5.0,3.7,1.3,4.3,3.2,1.1
14626570,Vierkirchen,14,Sachsen,1729,868,861,108,76,32,58,44,14,6.2,4.4,1.9,3.4,2.5,0.8
14626260,Kreba-Neudorf,14,Sachsen,884,449,435,43,35,8,22,-1,-1,4.9,4.0,0.9,2.5,,
14626460,Rietschen,14,Sachsen,2594,1252,1342,145,113,32,111,87,24,5.6,4.4,1.2,4.3,3.4,0.9
14626160,Hähnichen,14,Sachsen,1276,651,625,57,45,12,20,-1,-1,4.5,3.5,0.9,1.6,,
14626480,"Rothenburg/O.L., Stadt",14,Sachsen,4760,2374,2386,265,199,66,249,195,54,5.6,4.2,1.4,5.2,4.1,1.1
14626120,Groß Düben,14,Sachsen,1088,559,529,50,36,14,51,42,9,4.6,3.3,1.3,4.7,3.9,0.8
14626490,Schleife,14,Sachsen,2606,1283,1323,109,82,27,97,73,24,4.2,3.1,1.0,3.7,2.8,0.9
14626560,Trebendorf,14,Sachsen,925,452,473,46,33,13,15,10,5,5.0,3.6,1.4,1.6,1.1,0.5
14626590,Weißkeißel,14,Sachsen,1285,662,623,63,51,12,25,-1,-1,4.9,4.0,0.9,1.9,,
14626600,"Weißwasser/O.L., Stadt",14,Sachsen,16851,8110,8741,980,808,172,875,686,189,5.8,4.8,1.0,5.2,4.1,1.1
14626190,Hohendubrau,14,Sachsen,1941,963,978,98,68,30,54,44,10,5.0,3.5,1.5,2.8,2.3,0.5
14626320,Mücka,14,Sachsen,990,496,494,58,55,3,34,30,4,5.9,5.6,0.3,3.4,3.0,0.4
14626440,Quitzdorf am See,14,Sachsen,1499,749,750,63,47,16,89,60,29,4.2,3.1,1.1,5.9,4.0,1.9
14626580,Waldhufen,14,Sachsen,2413,1234,1179,104,73,31,92,56,36,4.3,3.0,1.3,3.8,2.3,1.5
14626200,Horka,14,Sachsen,1789,902,887,99,74,25,46,32,14,5.5,4.1,1.4,2.6,1.8,0.8
14626230,Kodersdorf,14,Sachsen,2535,1277,1258,134,89,45,97,70,27,5.3,3.5,1.8,3.8,2.8,1.1
14626330,Neißeaue,14,Sachsen,1726,859,867,94,78,16,102,92,10,5.4,4.5,0.9,5.9,5.3,0.6
14626520,Schöpstal,14,Sachsen,2439,1232,1207,126,80,46,74,46,28,5.2,3.3,1.9,3.0,1.9,1.1
14627010,"Coswig, Stadt",14,Sachsen,20831,10004,10827,1018,737,281,814,575,239,4.9,3.5,1.3,3.9,2.8,1.1
14627020,Diera-Zehren,14,Sachsen,3352,1691,1661,145,92,53,118,86,32,4.3,2.7,1.6,3.5,2.6,1.0
14627030,Ebersbach,14,Sachsen,4476,2279,2197,196,130,66,142,108,34,4.4,2.9,1.5,3.2,2.4,0.8
14627050,"Gröditz, Stadt",14,Sachsen,7409,3685,3724,370,307,63,323,270,53,5.0,4.1,0.9,4.4,3.6,0.7
14627060,"Großenhain, Stadt",14,Sachsen,18352,9052,9300,901,675,226,1028,757,271,4.9,3.7,1.2,5.6,4.1,1.5
14627070,Hirschstein,14,Sachsen,2072,1072,1000,88,63,25,54,38,16,4.2,3.0,1.2,2.6,1.8,0.8
14627080,Käbschütztal,14,Sachsen,2787,1430,1357,120,76,44,48,35,13,4.3,2.7,1.6,1.7,1.3,0.5
14627100,Klipphausen,14,Sachsen,10283,5240,5043,488,328,160,355,243,112,4.7,3.2,1.6,3.5,2.4,1.1
14627130,"Lommatzsch, Stadt",14,Sachsen,5074,2470,2604,195,144,51,202,157,45,3.8,2.8,1.0,4.0,3.1,0.9
14627140,"Meißen, Stadt",14,Sachsen,27936,13508,14428,1387,1059,328,1507,1121,386,5.0,3.8,1.2,5.4,4.0,1.4
14627150,Moritzburg,14,Sachsen,8310,4146,4164,415,275,140,552,424,128,5.0,3.3,1.7,6.6,5.1,1.5
14627170,Niederau,14,Sachsen,4460,2326,2134,198,138,60,144,116,28,4.4,3.1,1.3,3.2,2.6,0.6
14627180,"Nossen, Stadt",14,Sachsen,10820,5406,5414,560,397,163,608,456,152,5.2,3.7,1.5,5.6,4.2,1.4
14627200,Priestewitz,14,Sachsen,3240,1666,1574,129,95,34,81,67,14,4.0,2.9,1.0,2.5,2.1,0.4
14627210,"Radebeul, Stadt",14,Sachsen,34055,16545,17510,1655,1138,517,1627,1144,483,4.9,3.3,1.5,4.8,3.4,1.4
14627220,"Radeburg, Stadt",14,Sachsen,7395,3677,3718,428,299,129,373,276,97,5.8,4.0,1.7,5.0,3.7,1.3
14627230,"Riesa, Stadt",14,Sachsen,30885,14953,15932,1616,1265,351,1673,1293,380,5.2,4.1,1.1,5.4,4.2,1.2
14627260,Stauchitz,14,Sachsen,3106,1598,1508,149,103,46,73,50,23,4.8,3.3,1.5,2.4,1.6,0.7
14627270,"Strehla, Stadt",14,Sachsen,3764,1845,1919,180,132,48,158,110,48,4.8,3.5,1.3,4.2,2.9,1.3
14627310,Weinböhla,14,Sachsen,10246,5037,5209,466,317,149,343,244,99,4.5,3.1,1.5,3.3,2.4,1.0
14627360,Zeithain,14,Sachsen,5839,2958,2881,290,212,78,190,133,57,5.0,3.6,1.3,3.3,2.3,1.0
14627040,Glaubitz,14,Sachsen,2170,1269,901,81,62,19,74,60,14,3.7,2.9,0.9,3.4,2.8,0.6
14627190,Nünchritz,14,Sachsen,5661,2809,2852,278,199,79,206,138,68,4.9,3.5,1.4,3.6,2.4,1.2
14627240,Röderaue,14,Sachsen,2752,1385,1367,110,84,26,82,56,26,4.0,3.1,0.9,3.0,2.0,0.9
14627340,Wülknitz,14,Sachsen,1725,888,837,72,59,13,53,47,6,4.2,3.4,0.8,3.1,2.7,0.3
14627110,Lampertswalde,14,Sachsen,2614,1332,1282,124,95,29,73,52,21,4.7,3.6,1.1,2.8,2.0,0.8
14627250,Schönfeld,14,Sachsen,1886,928,958,87,56,31,52,30,22,4.6,3.0,1.6,2.8,1.6,1.2
14627280,Tauscha,14,Sachsen,1433,738,695,54,40,14,57,46,11,3.8,2.8,1.0,4.0,3.2,0.8
14627290,Thiendorf,14,Sachsen,2311,1195,1116,99,65,34,156,119,37,4.3,2.8,1.5,6.8,5.1,1.6
14628050,Bannewitz,14,Sachsen,10535,5104,5431,505,312,193,341,258,83,4.8,3.0,1.8,3.2,2.4,0.8
14628060,"Dippoldiswalde, Stadt",14,Sachsen,14529,7244,7285,632,429,203,672,462,210,4.3,3.0,1.4,4.6,3.2,1.4
14628100,Dürrröhrsdorf-Dittersbach,14,Sachsen,4212,2123,2089,197,122,75,165,112,53,4.7,2.9,1.8,3.9,2.7,1.3
14628110,"Freital, Stadt",14,Sachsen,39734,19519,20215,2140,1534,606,1888,1315,573,5.4,3.9,1.5,4.8,3.3,1.4
14628130,"Glashütte, Stadt",14,Sachsen,6771,3435,3336,335,240,95,226,175,51,4.9,3.5,1.4,3.3,2.6,0.8
14628160,"Heidenau, Stadt",14,Sachsen,17085,8576,8509,851,572,279,571,389,182,5.0,3.3,1.6,3.3,2.3,1.1
14628190,"Hohnstein, Stadt",14,Sachsen,3353,1682,1671,167,121,46,124,85,39,5.0,3.6,1.4,3.7,2.5,1.2
14628220,Kreischa,14,Sachsen,4509,2213,2296,238,165,73,309,202,107,5.3,3.7,1.6,6.9,4.5,2.4
14628260,"Neustadt i. Sa., Stadt",14,Sachsen,12516,6072,6444,703,512,191,615,450,165,5.6,4.1,1.5,4.9,3.6,1.3
14628300,"Rabenau, Stadt",14,Sachsen,4399,2209,2190,231,159,72,107,78,29,5.3,3.6,1.6,2.4,1.8,0.7
14628360,"Sebnitz, Stadt",14,Sachsen,9932,4915,5017,530,397,133,451,338,113,5.3,4.0,1.3,4.5,3.4,1.1
14628380,"Stolpen, Stadt",14,Sachsen,5679,2819,2860,226,151,75,176,129,47,4.0,2.7,1.3,3.1,2.3,0.8
14628410,"Wilsdruff, Stadt",14,Sachsen,13942,6908,7034,690,459,231,809,578,231,4.9,3.3,1.7,5.8,4.1,1.7
14628010,"Altenberg, Stadt",14,Sachsen,8211,4165,4046,447,330,117,386,302,84,5.4,4.0,1.4,4.7,3.7,1.0
14628170,Hermsdorf/Erzgeb.,14,Sachsen,815,411,404,46,28,18,34,23,11,5.6,3.4,2.2,4.2,2.8,1.3
14628020,"Bad Gottleuba-Berggießhübel, Stadt",14,Sachsen,5676,2848,2828,294,213,81,267,198,69,5.2,3.8,1.4,4.7,3.5,1.2
14628040,Bahretal,14,Sachsen,2202,1098,1104,111,73,38,56,30,26,5.0,3.3,1.7,2.5,1.4,1.2
14628230,"Liebstadt, Stadt",14,Sachsen,1339,690,649,51,36,15,29,11,18,3.8,2.7,1.1,2.2,0.8,1.3
14628030,"Bad Schandau, Stadt",14,Sachsen,3761,1858,1903,208,146,62,206,149,57,5.5,3.9,1.6,5.5,4.0,1.5
14628320,Rathmannsdorf,14,Sachsen,958,454,504,44,28,16,39,25,14,4.6,2.9,1.7,4.1,2.6,1.5
14628330,Reinhardtsdorf-Schöna,14,Sachsen,1359,692,667,58,41,17,34,26,8,4.3,3.0,1.3,2.5,1.9,0.6
14628080,"Dohna, Stadt",14,Sachsen,6299,3181,3118,314,214,100,246,166,80,5.0,3.4,1.6,3.9,2.6,1.3
14628250,Müglitztal,14,Sachsen,1895,968,927,106,74,32,83,58,25,5.6,3.9,1.7,4.4,3.1,1.3
14628140,Gohrisch,14,Sachsen,1985,996,989,93,68,25,69,53,16,4.7,3.4,1.3,3.5,2.7,0.8
14628210,"Königstein/Sächs. Schw., Stadt",14,Sachsen,2122,1072,1050,128,89,39,168,123,45,6.0,4.2,1.8,7.9,5.8,2.1
14628310,"Rathen, Kurort",14,Sachsen,341,171,170,26,10,16,35,26,9,7.6,2.9,4.7,10.3,7.6,2.6
14628340,Rosenthal-Bielatal,14,Sachsen,1667,836,831,71,48,23,53,40,13,4.3,2.9,1.4,3.2,2.4,0.8
14628390,Struppen,14,Sachsen,2523,1280,1243,124,84,40,44,29,15,4.9,3.3,1.6,1.7,1.1,0.6
14628240,Lohmen,14,Sachsen,3072,1487,1585,128,89,39,87,54,33,4.2,2.9,1.3,2.8,1.8,1.1
14628370,"Stadt Wehlen, Stadt",14,Sachsen,1622,831,791,62,46,16,43,37,6,3.8,2.8,1.0,2.7,2.3,0.4
14628070,Dohma,14,Sachsen,1939,971,968,72,51,21,40,34,6,3.7,2.6,1.1,2.1,1.8,0.3
14628270,"Pirna, Stadt",14,Sachsen,38010,18457,19553,1917,1386,531,1996,1447,549,5.0,3.6,1.4,5.3,3.8,1.4
14628150,Hartmannsdorf-Reichenau,14,Sachsen,1071,541,530,51,41,10,28,19,9,4.8,3.8,0.9,2.6,1.8,0.8
14628205,Klingenberg,14,Sachsen,6843,3465,3378,352,227,125,243,175,68,5.1,3.3,1.8,3.6,2.6,1.0
14628090,Dorfhain,14,Sachsen,1094,534,560,58,47,11,34,20,14,5.3,4.3,1.0,3.1,1.8,1.3
14628400,"Tharandt, Stadt",14,Sachsen,5412,2740,2672,288,203,85,236,153,83,5.3,3.8,1.6,4.4,2.8,1.5
14713000,"Leipzig, Stadt",14,Sachsen,560472,274414,286058,32075,23863,8212,37026,27470,9556,5.7,4.3,1.5,6.6,4.9,1.7
14729030,Bennewitz,14,Sachsen,4906,2444,2462,233,155,78,208,139,69,4.7,3.2,1.6,4.2,2.8,1.4
14729040,"Böhlen, Stadt",14,Sachsen,6770,3337,3433,303,237,66,270,214,56,4.5,3.5,1.0,4.0,3.2,0.8
14729050,"Borna, Stadt",14,Sachsen,19672,9576,10096,879,689,190,946,722,224,4.5,3.5,1.0,4.8,3.7,1.1
14729060,Borsdorf,14,Sachsen,8252,4051,4201,440,289,151,259,193,66,5.3,3.5,1.8,3.1,2.3,0.8
14729070,"Brandis, Stadt",14,Sachsen,9426,4624,4802,484,355,129,562,384,178,5.1,3.8,1.4,6.0,4.1,1.9
14729080,"Colditz, Stadt",14,Sachsen,8752,4308,4444,387,276,111,287,207,80,4.4,3.2,1.3,3.3,2.4,0.9
14729140,"Frohburg, Stadt",14,Sachsen,10204,5069,5135,497,371,126,378,277,101,4.9,3.6,1.2,3.7,2.7,1.0
14729160,"Grimma, Stadt",14,Sachsen,28480,14055,14425,1418,1024,394,1508,1057,451,5.0,3.6,1.4,5.3,3.7,1.6
14729170,"Groitzsch, Stadt",14,Sachsen,7626,3681,3945,388,298,90,286,212,74,5.1,3.9,1.2,3.8,2.8,1.0
14729190,Großpösna,14,Sachsen,5324,2656,2668,279,182,97,242,166,76,5.2,3.4,1.8,4.5,3.1,1.4
14729220,"Kitzscher, Stadt",14,Sachsen,5034,2475,2559,240,187,53,99,75,24,4.8,3.7,1.1,2.0,1.5,0.5
14729230,"Kohren-Sahlis, Stadt",14,Sachsen,2611,1311,1300,133,100,33,91,68,23,5.1,3.8,1.3,3.5,2.6,0.9
14729245,Lossatal,14,Sachsen,6064,3065,2999,226,171,55,167,118,49,3.7,2.8,0.9,2.8,1.9,0.8
14729250,Machern,14,Sachsen,6663,3299,3364,352,248,104,412,306,106,5.3,3.7,1.6,6.2,4.6,1.6
14729260,"Markkleeberg, Stadt",14,Sachsen,24240,11564,12676,1258,890,368,1369,970,399,5.2,3.7,1.5,5.6,4.0,1.6
14729270,"Markranstädt, Stadt",14,Sachsen,15119,7332,7787,750,518,232,651,443,208,5.0,3.4,1.5,4.3,2.9,1.4
14729320,Neukieritzsch,14,Sachsen,6879,3361,3518,306,229,77,167,128,39,4.4,3.3,1.1,2.4,1.9,0.6
14729360,"Regis-Breitingen, Stadt",14,Sachsen,4020,2088,1932,193,141,52,99,72,27,4.8,3.5,1.3,2.5,1.8,0.7
14729370,"Rötha, Stadt",14,Sachsen,6118,3109,3009,160,114,46,152,110,42,2.6,1.9,0.8,2.5,1.8,0.7
14729380,Thallwitz,14,Sachsen,3563,1819,1744,234,176,58,122,88,34,6.6,4.9,1.6,3.4,2.5,1.0
14729400,"Trebsen/Mulde, Stadt",14,Sachsen,3854,1922,1932,178,126,52,105,72,33,4.6,3.3,1.3,2.7,1.9,0.9
14729410,"Wurzen, Stadt",14,Sachsen,16364,7850,8514,858,618,240,769,550,219,5.2,3.8,1.5,4.7,3.4,1.3
14729430,"Zwenkau, Stadt",14,Sachsen,8908,4365,4543,478,364,114,454,350,104,5.4,4.1,1.3,5.1,3.9,1.2
14729010,"Bad Lausick, Stadt",14,Sachsen,8090,3962,4128,416,300,116,318,231,87,5.1,3.7,1.4,3.9,2.9,1.1
14729330,Otterwisch,14,Sachsen,1421,715,706,70,50,20,-1,-1,-1,4.9,3.5,1.4,-0.1,,
14729150,"Geithain, Stadt",14,Sachsen,5439,2656,2783,275,214,61,294,241,53,5.1,3.9,1.1,5.4,4.4,1.0
14729290,Narsdorf,14,Sachsen,1659,842,817,78,58,20,38,29,9,4.7,3.5,1.2,2.3,1.7,0.5
14729020,Belgershain,14,Sachsen,3339,1663,1676,165,107,58,81,52,29,4.9,3.2,1.7,2.4,1.6,0.9
14729300,"Naunhof, Stadt",14,Sachsen,8618,4229,4389,463,320,143,357,262,95,5.4,3.7,1.7,4.1,3.0,1.1
14729340,Parthenstein,14,Sachsen,3459,1742,1717,184,115,69,114,75,39,5.3,3.3,2.0,3.3,2.2,1.1
14729100,Elstertrebnitz,14,Sachsen,1283,653,630,66,51,15,-1,-1,-1,5.1,4.0,1.2,-0.1,,
14729350,"Pegau, Stadt",14,Sachsen,6251,3054,3197,318,205,113,215,157,58,5.1,3.3,1.8,3.4,2.5,0.9
14730020,"Bad Düben, Stadt",14,Sachsen,7956,3868,4088,437,342,95,380,290,90,5.5,4.3,1.2,4.8,3.6,1.1
14730045,"Belgern-Schildau, Stadt",14,Sachsen,7889,3972,3917,338,257,81,229,165,64,4.3,3.3,1.0,2.9,2.1,0.8
14730050,Cavertitz,14,Sachsen,2260,1163,1097,106,74,32,103,78,25,4.7,3.3,1.4,4.6,3.5,1.1
14730060,"Dahlen, Stadt",14,Sachsen,4270,2075,2195,248,177,71,167,118,49,5.8,4.1,1.7,3.9,2.8,1.1
14730070,"Delitzsch, Stadt",14,Sachsen,24850,12190,12660,1393,1018,375,1092,814,278,5.6,4.1,1.5,4.4,3.3,1.1
14730080,Doberschütz,14,Sachsen,4100,2043,2057,203,150,53,170,129,41,5.0,3.7,1.3,4.1,3.1,1.0
14730110,"Eilenburg, Stadt",14,Sachsen,15452,7436,8016,848,678,170,613,467,146,5.5,4.4,1.1,4.0,3.0,0.9
14730160,Laußig,14,Sachsen,3764,1915,1849,170,122,48,86,65,21,4.5,3.2,1.3,2.3,1.7,0.6
14730170,Liebschützberg,14,Sachsen,2996,1528,1468,149,106,43,109,77,32,5.0,3.5,1.4,3.6,2.6,1.1
14730180,Löbnitz,14,Sachsen,2065,1026,1039,125,90,35,81,61,20,6.1,4.4,1.7,3.9,3.0,1.0
14730190,Mockrehna,14,Sachsen,5023,2540,2483,227,171,56,184,145,39,4.5,3.4,1.1,3.7,2.9,0.8
14730200,"Mügeln, Stadt",14,Sachsen,6071,3002,3069,295,214,81,225,174,51,4.9,3.5,1.3,3.7,2.9,0.8
14730210,Naundorf,14,Sachsen,2354,1216,1138,107,69,38,60,31,29,4.5,2.9,1.6,2.5,1.3,1.2
14730230,"Oschatz, Stadt",14,Sachsen,14734,7188,7546,768,563,205,1456,1149,307,5.2,3.8,1.4,9.9,7.8,2.1
14730250,Rackwitz,14,Sachsen,4931,2539,2392,250,180,70,332,260,72,5.1,3.7,1.4,6.7,5.3,1.5
14730270,"Schkeuditz, Stadt",14,Sachsen,17443,8891,8552,944,649,295,1135,778,357,5.4,3.7,1.7,6.5,4.5,2.0
14730300,"Taucha, Stadt",14,Sachsen,15128,7323,7805,772,564,208,941,729,212,5.1,3.7,1.4,6.2,4.8,1.4
14730330,Wermsdorf,14,Sachsen,5309,2600,2709,230,157,73,158,112,46,4.3,3.0,1.4,3.0,2.1,0.9
14730340,Wiedemar,14,Sachsen,5208,2621,2587,263,170,93,296,220,76,5.0,3.3,1.8,5.7,4.2,1.5
14730010,Arzberg,14,Sachsen,1982,1021,961,88,61,27,35,26,9,4.4,3.1,1.4,1.8,1.3,0.5
14730030,Beilrode,14,Sachsen,4240,2137,2103,216,167,49,144,106,38,5.1,3.9,1.2,3.4,2.5,0.9
14730090,"Dommitzsch, Stadt",14,Sachsen,2564,1271,1293,122,97,25,67,51,16,4.8,3.8,1.0,2.6,2.0,0.6
14730120,Elsnig,14,Sachsen,1455,747,708,61,42,19,27,22,5,4.2,2.9,1.3,1.9,1.5,0.3
14730320,Trossin,14,Sachsen,1290,648,642,58,45,13,36,29,7,4.5,3.5,1.0,2.8,2.2,0.5
14730150,Krostitz,14,Sachsen,3763,1926,1837,217,136,81,204,125,79,5.8,3.6,2.2,5.4,3.3,2.1
14730280,Schönwölkau,14,Sachsen,2433,1227,1206,138,93,45,83,57,26,5.7,3.8,1.8,3.4,2.3,1.1
14730100,Dreiheide,14,Sachsen,2130,1074,1056,94,66,28,65,49,16,4.4,3.1,1.3,3.1,2.3,0.8
14730310,"Torgau, Stadt",14,Sachsen,20047,9901,10146,1053,808,245,1261,979,282,5.3,4.0,1.2,6.3,4.9,1.4
14730140,Jesewitz,14,Sachsen,3017,1523,1494,175,110,65,142,90,52,5.8,3.6,2.2,4.7,3.0,1.7
14730360,Zschepplin,14,Sachsen,2881,1441,1440,145,105,40,83,58,25,5.0,3.6,1.4,2.9,2.0,0.9
