ags,name,bundesland_id,bundesland,bevoelkerung_total,bevoelkerung_maennlich,bevoelkerung_weiblich,mj_wohnort_insgesamt,mj_wohnort_ausschliesslich,mj_wohnort_nebenjob,mj_arbeitsort_insgesamt,mj_arbeitsort_ausschliesslich,mj_arbeitsort_nebenjob,mj_wohnort_insgesamt_prozent,mj_wohnort_ausschliesslich_prozent,mj_wohnort_nebenjob_prozent,mj_arbeitsort_insgesamt_prozent,mj_arbeitsort_ausschliesslich_prozent,mj_arbeitsort_nebenjob_prozent
09161000,Ingolstadt,09,Bayern,132438,66825,65613,12033,7051,4982,14474,8717,5757,9.1,5.3,3.8,10.9,6.6,4.3
09162000,"München, Landeshauptstadt",09,Bayern,1450381,707150,743231,135613,72636,62977,147249,81670,65579,9.4,5.0,4.3,10.2,5.6,4.5
09163000,Rosenheim,09,Bayern,61844,30273,31571,6666,3803,2863,8415,5045,3370,10.8,6.1,4.6,13.6,8.2,5.4
09171111,"Altötting, St",09,Bayern,12750,6024,6726,1485,848,637,1996,1268,728,11.6,6.7,5.0,15.7,9.9,5.7
09171112,"Burghausen, St",09,Bayern,18259,8878,9381,1595,1002,593,1940,1205,735,8.7,5.5,3.2,10.6,6.6,4.0
09171113,Burgkirchen a.d.Alz,09,Bayern,10257,5094,5163,1149,696,453,845,528,317,11.2,6.8,4.4,8.2,5.1,3.1
09171117,Garching a.d.Alz,09,Bayern,8500,4152,4348,890,552,338,672,422,250,10.5,6.5,4.0,7.9,5.0,2.9
09171118,Haiming,09,Bayern,2421,1204,1217,232,159,73,185,120,65,9.6,6.6,3.0,7.6,5.0,2.7
09171125,"Neuötting, St",09,Bayern,8588,4200,4388,931,562,369,1030,641,389,10.8,6.5,4.3,12.0,7.5,4.5
09171127,Pleiskirchen,09,Bayern,2407,1249,1158,324,199,125,248,138,110,13.5,8.3,5.2,10.3,5.7,4.6
09171131,Teising,09,Bayern,1913,950,963,220,132,88,126,77,49,11.5,6.9,4.6,6.6,4.0,2.6
09171132,"Töging a.Inn, St",09,Bayern,9196,4487,4709,1068,654,414,843,517,326,11.6,7.1,4.5,9.2,5.6,3.5
09171133,"Tüßling, M",09,Bayern,3243,1599,1644,334,208,126,277,167,110,10.3,6.4,3.9,8.5,5.1,3.4
09171137,Winhöring,09,Bayern,4716,2306,2410,486,315,171,630,379,251,10.3,6.7,3.6,13.4,8.0,5.3
09171114,Emmerting,09,Bayern,4130,2073,2057,402,234,168,217,119,98,9.7,5.7,4.1,5.3,2.9,2.4
09171124,Mehring,09,Bayern,2403,1224,1179,178,114,64,171,105,66,7.4,4.7,2.7,7.1,4.4,2.7
09171116,Feichten a.d.Alz,09,Bayern,1157,586,571,126,72,54,76,37,39,10.9,6.2,4.7,6.6,3.2,3.4
09171119,Halsbach,09,Bayern,948,500,448,121,60,61,111,48,63,12.8,6.3,6.4,11.7,5.1,6.6
09171122,Kirchweidach,09,Bayern,2323,1176,1147,287,154,133,285,128,157,12.4,6.6,5.7,12.3,5.5,6.8
09171134,Tyrlaching,09,Bayern,948,484,464,95,57,38,55,26,29,10.0,6.0,4.0,5.8,2.7,3.1
09171123,"Marktl, M",09,Bayern,2677,1367,1310,257,158,99,330,208,122,9.6,5.9,3.7,12.3,7.8,4.6
09171130,Stammham,09,Bayern,985,496,489,101,66,35,48,33,15,10.3,6.7,3.6,4.9,3.4,1.5
09171115,Erlbach,09,Bayern,1171,577,594,139,74,65,76,39,37,11.9,6.3,5.6,6.5,3.3,3.2
09171126,Perach,09,Bayern,1240,600,640,135,82,53,68,40,28,10.9,6.6,4.3,5.5,3.2,2.3
09171129,Reischach,09,Bayern,2539,1268,1271,333,203,130,189,122,67,13.1,8.0,5.1,7.4,4.8,2.6
09171121,Kastl,09,Bayern,2725,1354,1371,303,195,108,218,119,99,11.1,7.2,4.0,8.0,4.4,3.6
09171135,Unterneukirchen,09,Bayern,2989,1521,1468,376,221,155,265,149,116,12.6,7.4,5.2,8.9,5.0,3.9
09172111,Ainring,09,Bayern,9672,4759,4913,1018,632,386,707,429,278,10.5,6.5,4.0,7.3,4.4,2.9
09172112,Anger,09,Bayern,4398,2266,2132,530,332,198,351,220,131,12.1,7.5,4.5,8.0,5.0,3.0
09172114,"Bad Reichenhall, GKSt",09,Bayern,17443,8241,9202,1817,1110,707,2301,1499,802,10.4,6.4,4.1,13.2,8.6,4.6
09172115,Bayerisch Gmain,09,Bayern,3110,1558,1552,245,150,95,342,235,107,7.9,4.8,3.1,11.0,7.6,3.4
09172116,"Berchtesgaden, M",09,Bayern,7888,3852,4036,857,510,347,1068,681,387,10.9,6.5,4.4,13.5,8.6,4.9
09172117,Bischofswiesen,09,Bayern,7500,3659,3841,820,496,324,527,325,202,10.9,6.6,4.3,7.0,4.3,2.7
09172118,"Freilassing, St",09,Bayern,16522,7999,8523,1490,915,575,1798,1112,686,9.0,5.5,3.5,10.9,6.7,4.2
09172122,"Laufen, St",09,Bayern,6954,3502,3452,573,413,160,616,420,196,8.2,5.9,2.3,8.9,6.0,2.8
09172124,"Marktschellenberg, M",09,Bayern,1741,882,859,193,139,54,120,75,45,11.1,8.0,3.1,6.9,4.3,2.6
09172128,Piding,09,Bayern,5384,2600,2784,605,396,209,487,303,184,11.2,7.4,3.9,9.0,5.6,3.4
09172129,Ramsau b.Berchtesgaden,09,Bayern,1747,878,869,219,140,79,179,104,75,12.5,8.0,4.5,10.2,6.0,4.3
09172130,Saaldorf-Surheim,09,Bayern,5378,2685,2693,518,345,173,343,216,127,9.6,6.4,3.2,6.4,4.0,2.4
09172131,Schneizlreuth,09,Bayern,1316,659,657,163,108,55,133,67,66,12.4,8.2,4.2,10.1,5.1,5.0
09172132,Schönau a.Königssee,09,Bayern,5544,2695,2849,611,351,260,622,339,283,11.0,6.3,4.7,11.2,6.1,5.1
09172134,"Teisendorf, M",09,Bayern,9310,4662,4648,1126,738,388,865,549,316,12.1,7.9,4.2,9.3,5.9,3.4
09173111,Bad Heilbrunn,09,Bayern,3822,1938,1884,436,242,194,267,150,117,11.4,6.3,5.1,7.0,3.9,3.1
09173112,"Bad Tölz, St",09,Bayern,18475,8798,9677,2266,1211,1055,2624,1501,1123,12.3,6.6,5.7,14.2,8.1,6.1
09173118,Dietramszell,09,Bayern,5442,2801,2641,666,381,285,446,245,201,12.2,7.0,5.2,8.2,4.5,3.7
09173120,Egling,09,Bayern,5456,2822,2634,609,339,270,537,296,241,11.2,6.2,4.9,9.8,5.4,4.4
09173123,Eurasburg,09,Bayern,4316,2188,2128,443,257,186,311,159,152,10.3,6.0,4.3,7.2,3.7,3.5
09173124,Gaißach,09,Bayern,3131,1584,1547,377,222,155,194,120,74,12.0,7.1,5.0,6.2,3.8,2.4
09173126,"Geretsried, St",09,Bayern,24392,11979,12413,2813,1462,1351,2319,1283,1036,11.5,6.0,5.5,9.5,5.3,4.2
09173130,Icking,09,Bayern,3780,1891,1889,293,186,107,240,141,99,7.8,4.9,2.8,6.3,3.7,2.6
09173131,Jachenau,09,Bayern,848,420,428,113,75,38,69,41,28,13.3,8.8,4.5,8.1,4.8,3.3
09173134,Königsdorf,09,Bayern,3029,1517,1512,374,221,153,292,152,140,12.3,7.3,5.1,9.6,5.0,4.6
09173135,Lenggries,09,Bayern,10030,4883,5147,1124,680,444,878,560,318,11.2,6.8,4.4,8.8,5.6,3.2
09173137,Münsing,09,Bayern,4254,2109,2145,391,233,158,357,209,148,9.2,5.5,3.7,8.4,4.9,3.5
09173145,Wackersberg,09,Bayern,3523,1748,1775,399,234,165,380,202,178,11.3,6.6,4.7,10.8,5.7,5.1
09173147,"Wolfratshausen, St",09,Bayern,18237,8802,9435,1815,1012,803,2522,1388,1134,10.0,5.5,4.4,13.8,7.6,6.2
09173113,Benediktbeuern,09,Bayern,3620,1785,1835,397,215,182,319,203,116,11.0,5.9,5.0,8.8,5.6,3.2
09173115,Bichl,09,Bayern,2187,1092,1095,234,148,86,149,84,65,10.7,6.8,3.9,6.8,3.8,3.0
09173133,Kochel a.See,09,Bayern,4053,1993,2060,457,256,201,431,249,182,11.3,6.3,5.0,10.6,6.1,4.5
09173142,Schlehdorf,09,Bayern,1223,579,644,129,68,61,118,54,64,10.5,5.6,5.0,9.6,4.4,5.2
09173127,Greiling,09,Bayern,1457,717,740,175,99,76,99,58,41,12.0,6.8,5.2,6.8,4.0,2.8
09173140,Reichersbeuern,09,Bayern,2317,1153,1164,282,160,122,129,85,44,12.2,6.9,5.3,5.6,3.7,1.9
09173141,Sachsenkam,09,Bayern,1338,663,675,176,108,68,125,71,54,13.2,8.1,5.1,9.3,5.3,4.0
09174111,"Altomünster, M",09,Bayern,7835,3971,3864,839,481,358,647,334,313,10.7,6.1,4.6,8.3,4.3,4.0
09174113,Bergkirchen,09,Bayern,7729,3968,3761,902,503,399,1119,597,522,11.7,6.5,5.2,14.5,7.7,6.8
09174115,"Dachau, GKSt",09,Bayern,46705,22874,23831,4730,2398,2332,4705,2615,2090,10.1,5.1,5.0,10.1,5.6,4.5
09174118,Erdweg,09,Bayern,5782,2950,2832,572,332,240,334,193,141,9.9,5.7,4.2,5.8,3.3,2.4
09174121,Haimhausen,09,Bayern,5332,2697,2635,527,318,209,431,266,165,9.9,6.0,3.9,8.1,5.0,3.1
09174122,Hebertshausen,09,Bayern,5484,2769,2715,556,331,225,382,221,161,10.1,6.0,4.1,7.0,4.0,2.9
09174126,Karlsfeld,09,Bayern,20096,10090,10006,2026,995,1031,3596,1563,2033,10.1,5.0,5.1,17.9,7.8,10.1
09174131,"Markt Indersdorf, M",09,Bayern,10223,5267,4956,1165,607,558,978,549,429,11.4,5.9,5.5,9.6,5.4,4.2
09174136,Petershausen,09,Bayern,6394,3190,3204,648,389,259,559,350,209,10.1,6.1,4.1,8.7,5.5,3.3
09174141,Röhrmoos,09,Bayern,6429,3195,3234,538,301,237,404,226,178,8.4,4.7,3.7,6.3,3.5,2.8
09174143,Schwabhausen,09,Bayern,6416,3241,3175,715,383,332,471,239,232,11.1,6.0,5.2,7.3,3.7,3.6
09174147,Hilgertshausen-Tandern,09,Bayern,3307,1692,1615,349,210,139,271,153,118,10.6,6.4,4.2,8.2,4.6,3.6
09174150,Vierkirchen,09,Bayern,4588,2333,2255,448,267,181,367,249,118,9.8,5.8,3.9,8.0,5.4,2.6
09174151,Weichs,09,Bayern,3345,1633,1712,371,199,172,181,93,88,11.1,5.9,5.1,5.4,2.8,2.6
09174135,Odelzhausen,09,Bayern,4965,2493,2472,517,282,235,492,302,190,10.4,5.7,4.7,9.9,6.1,3.8
09174137,Pfaffenhofen a.d.Glonn,09,Bayern,2040,1033,1007,216,117,99,197,83,114,10.6,5.7,4.9,9.7,4.1,5.6
09174146,Sulzemoos,09,Bayern,2700,1349,1351,310,157,153,180,103,77,11.5,5.8,5.7,6.7,3.8,2.9
09175111,Anzing,09,Bayern,4115,2090,2025,401,229,172,279,179,100,9.7,5.6,4.2,6.8,4.3,2.4
09175115,"Ebersberg, St",09,Bayern,11935,5872,6063,1142,646,496,1214,648,566,9.6,5.4,4.2,10.2,5.4,4.7
09175118,Forstinning,09,Bayern,3683,1852,1831,372,213,159,409,215,194,10.1,5.8,4.3,11.1,5.8,5.3
09175122,"Grafing b.München, St",09,Bayern,13480,6581,6899,1278,766,512,1301,808,493,9.5,5.7,3.8,9.7,6.0,3.7
09175123,Hohenlinden,09,Bayern,3057,1581,1476,318,177,141,350,165,185,10.4,5.8,4.6,11.4,5.4,6.1
09175124,"Kirchseeon, M",09,Bayern,10446,5395,5051,908,495,413,546,338,208,8.7,4.7,4.0,5.2,3.2,2.0
09175127,"Markt Schwaben, M",09,Bayern,13333,6742,6591,1305,693,612,1142,641,501,9.8,5.2,4.6,8.6,4.8,3.8
09175132,Vaterstetten,09,Bayern,22768,11099,11669,1880,1140,740,2366,1321,1045,8.3,5.0,3.3,10.4,5.8,4.6
09175133,Pliening,09,Bayern,5349,2688,2661,515,291,224,387,230,157,9.6,5.4,4.2,7.2,4.3,2.9
09175135,Poing,09,Bayern,14596,7269,7327,1420,743,677,917,521,396,9.7,5.1,4.6,6.3,3.6,2.7
09175137,Steinhöring,09,Bayern,4035,2032,2003,419,224,195,275,143,132,10.4,5.6,4.8,6.8,3.5,3.3
09175139,Zorneding,09,Bayern,9156,4500,4656,747,456,291,493,274,219,8.2,5.0,3.2,5.4,3.0,2.4
09175112,Aßling,09,Bayern,4438,2204,2234,479,300,179,316,215,101,10.8,6.8,4.0,7.1,4.8,2.3
09175119,Frauenneuharting,09,Bayern,1517,784,733,161,100,61,83,40,43,10.6,6.6,4.0,5.5,2.6,2.8
09175136,Emmering,09,Bayern,1531,772,759,178,117,61,68,37,31,11.6,7.6,4.0,4.4,2.4,2.0
09175113,Baiern,09,Bayern,1431,730,701,188,108,80,155,102,53,13.1,7.5,5.6,10.8,7.1,3.7
09175114,Bruck,09,Bayern,1244,641,603,127,85,42,63,37,26,10.2,6.8,3.4,5.1,3.0,2.1
09175116,Egmating,09,Bayern,2314,1184,1130,196,115,81,154,78,76,8.5,5.0,3.5,6.7,3.4,3.3
09175121,"Glonn, M",09,Bayern,5081,2534,2547,567,301,266,581,295,286,11.2,5.9,5.2,11.4,5.8,5.6
09175128,Moosach,09,Bayern,1532,769,763,139,82,57,292,192,100,9.1,5.4,3.7,19.1,12.5,6.5
09175131,Oberpframmern,09,Bayern,2380,1245,1135,235,127,108,244,98,146,9.9,5.3,4.5,10.3,4.1,6.1
09176112,"Altmannstein, M",09,Bayern,6958,3538,3420,652,448,204,480,311,169,9.4,6.4,2.9,6.9,4.5,2.4
09176114,"Beilngries, St",09,Bayern,9258,4810,4448,971,610,361,927,575,352,10.5,6.6,3.9,10.0,6.2,3.8
09176118,Buxheim,09,Bayern,3659,1842,1817,299,199,100,162,107,55,8.2,5.4,2.7,4.4,2.9,1.5
09176120,Denkendorf,09,Bayern,4712,2457,2255,420,267,153,442,263,179,8.9,5.7,3.2,9.4,5.6,3.8
09176121,"Dollnstein, M",09,Bayern,2789,1459,1330,239,167,72,161,110,51,8.6,6.0,2.6,5.8,3.9,1.8
09176123,"Eichstätt, GKSt",09,Bayern,13407,6486,6921,1448,995,453,2121,1525,596,10.8,7.4,3.4,15.8,11.4,4.4
09176126,"Gaimersheim, M",09,Bayern,11618,5790,5828,944,599,345,1602,846,756,8.1,5.2,3.0,13.8,7.3,6.5
09176129,Großmehring,09,Bayern,6695,3430,3265,630,386,244,371,224,147,9.4,5.8,3.6,5.5,3.3,2.2
09176131,Hepberg,09,Bayern,2859,1463,1396,218,139,79,137,94,43,7.6,4.9,2.8,4.8,3.3,1.5
09176132,Hitzhofen,09,Bayern,2871,1492,1379,235,162,73,92,61,31,8.2,5.6,2.5,3.2,2.1,1.1
09176137,"Kinding, M",09,Bayern,2591,1327,1264,292,199,93,287,187,100,11.3,7.7,3.6,11.1,7.2,3.9
09176138,"Kipfenberg, M",09,Bayern,5752,2919,2833,491,322,169,377,245,132,8.5,5.6,2.9,6.6,4.3,2.3
09176139,"Kösching, M",09,Bayern,9428,4701,4727,763,471,292,555,355,200,8.1,5.0,3.1,5.9,3.8,2.1
09176143,Lenting,09,Bayern,4851,2434,2417,451,282,169,359,191,168,9.3,5.8,3.5,7.4,3.9,3.5
09176148,"Mörnsheim, M",09,Bayern,1542,785,757,152,101,51,73,48,25,9.9,6.5,3.3,4.7,3.1,1.6
09176161,Stammham,09,Bayern,3906,1966,1940,343,233,110,228,128,100,8.8,6.0,2.8,5.8,3.3,2.6
09176164,"Titting, M",09,Bayern,2675,1430,1245,254,174,80,175,118,57,9.5,6.5,3.0,6.5,4.4,2.1
09176166,"Wellheim, M",09,Bayern,2700,1359,1341,229,144,85,163,93,70,8.5,5.3,3.1,6.0,3.4,2.6
09176167,Wettstetten,09,Bayern,4851,2470,2381,376,244,132,281,164,117,7.8,5.0,2.7,5.8,3.4,2.4
09176155,Pollenfeld,09,Bayern,2836,1452,1384,336,219,117,219,133,86,11.8,7.7,4.1,7.7,4.7,3.0
09176160,Schernfeld,09,Bayern,3155,1622,1533,304,184,120,133,76,57,9.6,5.8,3.8,4.2,2.4,1.8
09176165,Walting,09,Bayern,2328,1210,1118,214,136,78,116,79,37,9.2,5.8,3.4,5.0,3.4,1.6
09176116,Böhmfeld,09,Bayern,1644,860,784,130,84,46,97,68,29,7.9,5.1,2.8,5.9,4.1,1.8
09176124,Eitensheim,09,Bayern,2966,1512,1454,234,154,80,123,88,35,7.9,5.2,2.7,4.1,3.0,1.2
09176111,Adelschlag,09,Bayern,2948,1491,1457,267,180,87,98,61,37,9.1,6.1,3.0,3.3,2.1,1.3
09176122,Egweil,09,Bayern,1149,576,573,138,86,52,59,35,24,12.0,7.5,4.5,5.1,3.0,2.1
09176149,"Nassenfels, M",09,Bayern,2088,1069,1019,199,135,64,147,92,55,9.5,6.5,3.1,7.0,4.4,2.6
09176147,Mindelstetten,09,Bayern,1658,832,826,195,136,59,134,75,59,11.8,8.2,3.6,8.1,4.5,3.6
09176150,Oberdolling,09,Bayern,1272,637,635,158,96,62,127,71,56,12.4,7.5,4.9,10.0,5.6,4.4
09176153,"Pförring, M",09,Bayern,3639,1865,1774,406,283,123,355,246,109,11.2,7.8,3.4,9.8,6.8,3.0
09177113,Bockhorn,09,Bayern,3720,1890,1830,375,208,167,192,108,84,10.1,5.6,4.5,5.2,2.9,2.3
09177115,"Dorfen, St",09,Bayern,14407,7209,7198,1413,807,606,1216,716,500,9.8,5.6,4.2,8.4,5.0,3.5
09177117,"Erding, GKSt",09,Bayern,36159,17544,18615,4011,2127,1884,4947,2751,2196,11.1,5.9,5.2,13.7,7.6,6.1
09177118,Finsing,09,Bayern,4447,2234,2213,489,268,221,373,186,187,11.0,6.0,5.0,8.4,4.2,4.2
09177119,Forstern,09,Bayern,3592,1882,1710,395,213,182,301,172,129,11.0,5.9,5.1,8.4,4.8,3.6
09177120,Fraunberg,09,Bayern,3515,1779,1736,431,235,196,341,169,172,12.3,6.7,5.6,9.7,4.8,4.9
09177123,"Isen, M",09,Bayern,5746,2951,2795,645,379,266,448,269,179,11.2,6.6,4.6,7.8,4.7,3.1
09177127,Lengdorf,09,Bayern,2719,1384,1335,270,167,103,155,102,53,9.9,6.1,3.8,5.7,3.8,1.9
09177130,Moosinning,09,Bayern,5648,2856,2792,591,323,268,398,202,196,10.5,5.7,4.7,7.0,3.6,3.5
09177137,Sankt Wolfgang,09,Bayern,4426,2276,2150,505,287,218,476,251,225,11.4,6.5,4.9,10.8,5.7,5.1
09177139,Taufkirchen (Vils),09,Bayern,9750,4959,4791,1052,583,469,997,570,427,10.8,6.0,4.8,10.2,5.8,4.4
09177114,Buch a.Buchrain,09,Bayern,1516,782,734,161,93,68,93,55,38,10.6,6.1,4.5,6.1,3.6,2.5
09177135,Pastetten,09,Bayern,2596,1352,1244,272,142,130,196,107,89,10.5,5.5,5.0,7.6,4.1,3.4
09177142,Walpertskirchen,09,Bayern,2106,1088,1018,228,123,105,97,52,45,10.8,5.8,5.0,4.6,2.5,2.1
09177144,Wörth,09,Bayern,4403,2230,2173,440,261,179,209,132,77,10.0,5.9,4.1,4.7,3.0,1.7
09177116,Eitting,09,Bayern,2704,1423,1281,355,172,183,280,140,140,13.1,6.4,6.8,10.4,5.2,5.2
09177133,Oberding,09,Bayern,6151,3140,3011,676,345,331,1123,524,599,11.0,5.6,5.4,18.3,8.5,9.7
09177131,Neuching,09,Bayern,2527,1292,1235,272,138,134,228,108,120,10.8,5.5,5.3,9.0,4.3,4.7
09177134,Ottenhofen,09,Bayern,1913,986,927,185,121,64,92,50,42,9.7,6.3,3.3,4.8,2.6,2.2
09177121,Hohenpolding,09,Bayern,1510,774,736,159,88,71,90,53,37,10.5,5.8,4.7,6.0,3.5,2.5
09177122,Inning a.Holz,09,Bayern,1456,737,719,184,108,76,77,38,39,12.6,7.4,5.2,5.3,2.6,2.7
09177124,Kirchberg,09,Bayern,997,522,475,112,59,53,74,43,31,11.2,5.9,5.3,7.4,4.3,3.1
09177138,Steinkirchen,09,Bayern,1212,614,598,142,96,46,96,57,39,11.7,7.9,3.8,7.9,4.7,3.2
09177112,Berglern,09,Bayern,2711,1393,1318,341,174,167,138,72,66,12.6,6.4,6.2,5.1,2.7,2.4
09177126,Langenpreising,09,Bayern,2731,1428,1303,283,162,121,141,76,65,10.4,5.9,4.4,5.2,2.8,2.4
09177143,"Wartenberg, M",09,Bayern,5085,2596,2489,584,317,267,563,306,257,11.5,6.2,5.3,11.1,6.0,5.1
09178116,"Au i.d.Hallertau, M",09,Bayern,5858,3027,2831,616,365,251,564,326,238,10.5,6.2,4.3,9.6,5.6,4.1
09178120,Eching,09,Bayern,13809,7086,6723,1385,743,642,1450,770,680,10.0,5.4,4.6,10.5,5.6,4.9
09178122,Rudelzhausen,09,Bayern,3325,1694,1631,389,237,152,265,170,95,11.7,7.1,4.6,8.0,5.1,2.9
09178123,Fahrenzhausen,09,Bayern,4784,2497,2287,479,254,225,444,251,193,10.0,5.3,4.7,9.3,5.2,4.0
09178124,"Freising, GKSt",09,Bayern,46963,23568,23395,4973,2701,2272,5401,2944,2457,10.6,5.8,4.8,11.5,6.3,5.2
09178130,Hallbergmoos,09,Bayern,10524,5396,5128,1246,556,690,1541,732,809,11.8,5.3,6.6,14.6,7.0,7.7
09178133,Hohenkammer,09,Bayern,2432,1237,1195,257,131,126,264,128,136,10.6,5.4,5.2,10.9,5.3,5.6
09178136,Kirchdorf a.d.Amper,09,Bayern,3082,1622,1460,334,195,139,248,146,102,10.8,6.3,4.5,8.0,4.7,3.3
09178137,Kranzberg,09,Bayern,4118,2091,2027,431,229,202,365,195,170,10.5,5.6,4.9,8.9,4.7,4.1
09178138,Langenbach,09,Bayern,3887,1975,1912,419,234,185,734,468,266,10.8,6.0,4.8,18.9,12.0,6.8
09178140,Marzling,09,Bayern,3179,1626,1553,297,168,129,116,64,52,9.3,5.3,4.1,3.6,2.0,1.6
09178143,"Moosburg a.d.Isar, St",09,Bayern,17847,8855,8992,1751,967,784,1427,882,545,9.8,5.4,4.4,8.0,4.9,3.1
09178144,"Nandlstadt, M",09,Bayern,5120,2604,2516,539,314,225,308,205,103,10.5,6.1,4.4,6.0,4.0,2.0
09178145,Neufahrn b.Freising,09,Bayern,19468,9988,9480,2283,1180,1103,1731,876,855,11.7,6.1,5.7,8.9,4.5,4.4
09178113,Allershausen,09,Bayern,5583,2940,2643,605,322,283,621,310,311,10.8,5.8,5.1,11.1,5.6,5.6
09178150,Paunzhausen,09,Bayern,1536,790,746,167,106,61,106,50,56,10.9,6.9,4.0,6.9,3.3,3.6
09178125,Gammelsdorf,09,Bayern,1424,745,679,163,95,68,130,69,61,11.4,6.7,4.8,9.1,4.8,4.3
09178132,Hörgertshausen,09,Bayern,1924,977,947,191,115,76,89,43,46,9.9,6.0,4.0,4.6,2.2,2.4
09178142,Mauern,09,Bayern,3020,1538,1482,297,167,130,239,124,115,9.8,5.5,4.3,7.9,4.1,3.8
09178155,Wang,09,Bayern,2565,1343,1222,224,134,90,203,121,82,8.7,5.2,3.5,7.9,4.7,3.2
09178115,Attenkirchen,09,Bayern,2647,1332,1315,288,170,118,194,112,82,10.9,6.4,4.5,7.3,4.2,3.1
09178129,Haag a.d.Amper,09,Bayern,2884,1472,1412,306,184,122,176,94,82,10.6,6.4,4.2,6.1,3.3,2.8
09178156,Wolfersdorf,09,Bayern,2545,1350,1195,238,136,102,96,61,35,9.4,5.3,4.0,3.8,2.4,1.4
09178157,Zolling,09,Bayern,4701,2396,2305,480,258,222,310,174,136,10.2,5.5,4.7,6.6,3.7,2.9
09179113,Alling,09,Bayern,3737,1892,1845,421,234,187,364,188,176,11.3,6.3,5.0,9.7,5.0,4.7
09179117,Egenhofen,09,Bayern,3346,1697,1649,419,239,180,272,132,140,12.5,7.1,5.4,8.1,3.9,4.2
09179118,Eichenau,09,Bayern,11912,5851,6061,987,614,373,632,394,238,8.3,5.2,3.1,5.3,3.3,2.0
09179119,Emmering,09,Bayern,6777,3376,3401,757,420,337,528,291,237,11.2,6.2,5.0,7.8,4.3,3.5
09179121,"Fürstenfeldbruck, GKSt",09,Bayern,35708,17355,18353,3877,2106,1771,4677,2702,1975,10.9,5.9,5.0,13.1,7.6,5.5
09179123,"Germering, GKSt",09,Bayern,39387,18916,20471,3991,2230,1761,2729,1600,1129,10.1,5.7,4.5,6.9,4.1,2.9
09179126,Gröbenzell,09,Bayern,19780,9570,10210,1701,1012,689,1664,943,721,8.6,5.1,3.5,8.4,4.8,3.6
09179134,Maisach,09,Bayern,13608,6666,6942,1379,777,602,1235,683,552,10.1,5.7,4.4,9.1,5.0,4.1
09179138,Moorenweis,09,Bayern,4009,2059,1950,448,269,179,338,202,136,11.2,6.7,4.5,8.4,5.0,3.4
09179142,"Olching, St",09,Bayern,26825,13119,13706,2646,1503,1143,2003,1115,888,9.9,5.6,4.3,7.5,4.2,3.3
09179145,"Puchheim, St",09,Bayern,21111,10212,10899,2019,1133,886,1587,801,786,9.6,5.4,4.2,7.5,3.8,3.7
09179149,Türkenfeld,09,Bayern,3780,1908,1872,365,231,134,283,171,112,9.7,6.1,3.5,7.5,4.5,3.0
09179111,Adelshofen,09,Bayern,1621,817,804,206,106,100,86,49,37,12.7,6.5,6.2,5.3,3.0,2.3
09179114,Althegnenberg,09,Bayern,1986,996,990,200,118,82,98,57,41,10.1,5.9,4.1,4.9,2.9,2.1
09179128,Hattenhofen,09,Bayern,1530,773,757,187,103,84,141,69,72,12.2,6.7,5.5,9.2,4.5,4.7
09179130,Jesenwang,09,Bayern,1529,716,813,174,86,88,164,75,89,11.4,5.6,5.8,10.7,4.9,5.8
09179132,Landsberied,09,Bayern,1533,767,766,168,90,78,66,30,36,11.0,5.9,5.1,4.3,2.0,2.3
09179136,Mammendorf,09,Bayern,4712,2391,2321,533,304,229,528,300,228,11.3,6.5,4.9,11.2,6.4,4.8
09179137,Mittelstetten,09,Bayern,1683,829,854,201,135,66,93,50,43,11.9,8.0,3.9,5.5,3.0,2.6
09179140,Oberschweinbach,09,Bayern,1707,828,879,179,84,95,121,61,60,10.5,4.9,5.6,7.1,3.6,3.5
09179125,Grafrath,09,Bayern,3791,1839,1952,357,225,132,373,230,143,9.4,5.9,3.5,9.8,6.1,3.8
09179131,Kottgeisering,09,Bayern,1564,751,813,153,98,55,52,29,23,9.8,6.3,3.5,3.3,1.9,1.5
09179147,Schöngeising,09,Bayern,1845,945,900,203,133,70,129,82,47,11.0,7.2,3.8,7.0,4.4,2.5
09180112,Bad Kohlgrub,09,Bayern,2689,1330,1359,258,155,103,201,128,73,9.6,5.8,3.8,7.5,4.8,2.7
09180116,Farchant,09,Bayern,3655,1763,1892,499,295,204,309,166,143,13.7,8.1,5.6,8.5,4.5,3.9
09180117,"Garmisch-Partenkirchen, M",09,Bayern,26821,12763,14058,3018,1654,1364,3380,1935,1445,11.3,6.2,5.1,12.6,7.2,5.4
09180118,Grainau,09,Bayern,3508,1718,1790,396,246,150,282,170,112,11.3,7.0,4.3,8.0,4.8,3.2
09180122,Krün,09,Bayern,1910,950,960,203,130,73,170,106,64,10.6,6.8,3.8,8.9,5.5,3.4
09180123,"Mittenwald, M",09,Bayern,7413,3677,3736,838,521,317,747,465,282,11.3,7.0,4.3,10.1,6.3,3.8
09180124,"Murnau a.Staffelsee, M",09,Bayern,12184,5786,6398,1219,690,529,1578,913,665,10.0,5.7,4.3,13.0,7.5,5.5
09180125,Oberammergau,09,Bayern,5208,2500,2708,578,337,241,584,342,242,11.1,6.5,4.6,11.2,6.6,4.6
09180126,Oberau,09,Bayern,3245,1587,1658,375,211,164,259,143,116,11.6,6.5,5.1,8.0,4.4,3.6
09180134,Uffing a.Staffelsee,09,Bayern,2973,1431,1542,298,184,114,243,161,82,10.0,6.2,3.8,8.2,5.4,2.8
09180136,Wallgau,09,Bayern,1458,731,727,140,74,66,109,60,49,9.6,5.1,4.5,7.5,4.1,3.4
09180113,Bad Bayersoien,09,Bayern,1186,601,585,111,71,40,87,50,37,9.4,6.0,3.4,7.3,4.2,3.1
09180129,Saulgrub,09,Bayern,1640,816,824,211,134,77,96,58,38,12.9,8.2,4.7,5.9,3.5,2.3
09180115,Ettal,09,Bayern,789,437,352,93,55,38,105,72,33,11.8,7.0,4.8,13.3,9.1,4.2
09180135,Unterammergau,09,Bayern,1514,773,741,150,91,59,110,69,41,9.9,6.0,3.9,7.3,4.6,2.7
09180114,Eschenlohe,09,Bayern,1569,773,796,175,108,67,103,56,47,11.2,6.9,4.3,6.6,3.6,3.0
09180119,Großweil,09,Bayern,1440,705,735,174,102,72,85,50,35,12.1,7.1,5.0,5.9,3.5,2.4
09180127,Ohlstadt,09,Bayern,3267,1581,1686,356,193,163,218,110,108,10.9,5.9,5.0,6.7,3.4,3.3
09180131,Schwaigen,09,Bayern,593,308,285,46,29,17,-1,-1,-1,7.8,4.9,2.9,-0.2,,
09180128,Riegsee,09,Bayern,1204,592,612,119,76,43,82,45,37,9.9,6.3,3.6,6.8,3.7,3.1
09180132,Seehausen a.Staffelsee,09,Bayern,2394,1176,1218,221,135,86,201,117,84,9.2,5.6,3.6,8.4,4.9,3.5
09180133,Spatzenhausen,09,Bayern,725,372,353,85,47,38,-1,-1,-1,11.7,6.5,5.2,-0.1,,
09181113,Denklingen,09,Bayern,2581,1313,1268,283,185,98,243,159,84,11.0,7.2,3.8,9.4,6.2,3.3
09181114,"Dießen am Ammersee, M",09,Bayern,10326,4951,5375,899,579,320,814,514,300,8.7,5.6,3.1,7.9,5.0,2.9
09181116,Egling a.d.Paar,09,Bayern,2247,1135,1112,259,157,102,169,95,74,11.5,7.0,4.5,7.5,4.2,3.3
09181122,Geltendorf,09,Bayern,5556,2811,2745,517,320,197,327,208,119,9.3,5.8,3.5,5.9,3.7,2.1
09181128,"Kaufering, M",09,Bayern,10149,4966,5183,1035,592,443,916,577,339,10.2,5.8,4.4,9.0,5.7,3.3
09181130,"Landsberg am Lech, GKSt",09,Bayern,28708,14279,14429,2927,1747,1180,3934,2334,1600,10.2,6.1,4.1,13.7,8.1,5.6
09181132,Penzing,09,Bayern,3685,1866,1819,426,265,161,272,172,100,11.6,7.2,4.4,7.4,4.7,2.7
09181144,Utting am Ammersee,09,Bayern,4562,2285,2277,456,309,147,450,296,154,10.0,6.8,3.2,9.9,6.5,3.4
09181145,Weil,09,Bayern,3775,1948,1827,458,290,168,246,153,93,12.1,7.7,4.5,6.5,4.1,2.5
09181121,Fuchstal,09,Bayern,3743,1924,1819,388,240,148,320,193,127,10.4,6.4,4.0,8.5,5.2,3.4
09181143,Unterdießen,09,Bayern,1436,740,696,155,94,61,84,41,43,10.8,6.5,4.2,5.8,2.9,3.0
09181126,Hurlach,09,Bayern,1820,913,907,194,115,79,168,106,62,10.7,6.3,4.3,9.2,5.8,3.4
09181127,Igling,09,Bayern,2495,1237,1258,272,155,117,170,99,71,10.9,6.2,4.7,6.8,4.0,2.8
09181131,Obermeitingen,09,Bayern,1669,885,784,144,76,68,62,22,40,8.6,4.6,4.1,3.7,1.3,2.4
09181134,Prittriching,09,Bayern,2474,1248,1226,276,174,102,187,124,63,11.2,7.0,4.1,7.6,5.0,2.5
09181138,Scheuring,09,Bayern,1934,984,950,217,141,76,136,90,46,11.2,7.3,3.9,7.0,4.7,2.4
09181124,Hofstetten,09,Bayern,1838,941,897,216,130,86,121,78,43,11.8,7.1,4.7,6.6,4.2,2.3
09181140,Schwifting,09,Bayern,969,485,484,114,73,41,68,36,32,11.8,7.5,4.2,7.0,3.7,3.3
09181141,Pürgen,09,Bayern,3476,1771,1705,316,197,119,229,137,92,9.1,5.7,3.4,6.6,3.9,2.6
09181111,Apfeldorf,09,Bayern,1136,578,558,124,76,48,81,44,37,10.9,6.7,4.2,7.1,3.9,3.3
09181129,Kinsau,09,Bayern,1048,530,518,121,81,40,106,62,44,11.5,7.7,3.8,10.1,5.9,4.2
09181133,Vilgertshofen,09,Bayern,2600,1306,1294,262,156,106,182,116,66,10.1,6.0,4.1,7.0,4.5,2.5
09181135,Reichling,09,Bayern,1668,849,819,189,114,75,187,124,63,11.3,6.8,4.5,11.2,7.4,3.8
09181137,Rott,09,Bayern,1577,778,799,192,115,77,148,86,62,12.2,7.3,4.9,9.4,5.5,3.9
09181142,Thaining,09,Bayern,972,486,486,110,71,39,81,47,34,11.3,7.3,4.0,8.3,4.8,3.5
09181115,Eching am Ammersee,09,Bayern,1681,831,850,164,88,76,134,81,53,9.8,5.2,4.5,8.0,4.8,3.2
09181123,Greifenberg,09,Bayern,2228,1112,1116,193,111,82,177,111,66,8.7,5.0,3.7,7.9,5.0,3.0
09181139,Schondorf am Ammersee,09,Bayern,3944,1967,1977,320,213,107,317,187,130,8.1,5.4,2.7,8.0,4.7,3.3
09181118,Eresing,09,Bayern,1790,954,836,164,102,62,222,131,91,9.2,5.7,3.5,12.4,7.3,5.1
09181120,Finning,09,Bayern,1811,922,889,168,99,69,86,54,32,9.3,5.5,3.8,4.7,3.0,1.8
09181146,Windach,09,Bayern,3759,1893,1866,323,205,118,215,148,67,8.6,5.5,3.1,5.7,3.9,1.8
09182111,Bad Wiessee,09,Bayern,4913,2322,2591,542,310,232,589,317,272,11.0,6.3,4.7,12.0,6.5,5.5
09182112,Bayrischzell,09,Bayern,1605,801,804,214,120,94,247,142,105,13.3,7.5,5.9,15.4,8.8,6.5
09182114,Fischbachau,09,Bayern,5679,2851,2828,669,402,267,417,236,181,11.8,7.1,4.7,7.3,4.2,3.2
09182116,Gmund a.Tegernsee,09,Bayern,6012,2917,3095,662,401,261,573,334,239,11.0,6.7,4.3,9.5,5.6,4.0
09182119,Hausham,09,Bayern,8291,4090,4201,1080,569,511,737,382,355,13.0,6.9,6.2,8.9,4.6,4.3
09182120,"Holzkirchen, M",09,Bayern,16260,7932,8328,1521,877,644,1568,948,620,9.4,5.4,4.0,9.6,5.8,3.8
09182123,Irschenberg,09,Bayern,3206,1629,1577,389,223,166,384,207,177,12.1,7.0,5.2,12.0,6.5,5.5
09182124,Kreuth,09,Bayern,3637,1722,1915,406,237,169,341,184,157,11.2,6.5,4.6,9.4,5.1,4.3
09182125,"Miesbach, St",09,Bayern,11382,5501,5881,1332,704,628,1773,1037,736,11.7,6.2,5.5,15.6,9.1,6.5
09182127,Otterfing,09,Bayern,4699,2403,2296,430,256,174,444,239,205,9.2,5.4,3.7,9.4,5.1,4.4
09182129,Rottach-Egern,09,Bayern,5733,2545,3188,575,350,225,833,473,360,10.0,6.1,3.9,14.5,8.3,6.3
09182131,"Schliersee, M",09,Bayern,6799,3268,3531,681,410,271,804,458,346,10.0,6.0,4.0,11.8,6.7,5.1
09182132,"Tegernsee, St",09,Bayern,3880,1926,1954,416,239,177,471,279,192,10.7,6.2,4.6,12.1,7.2,4.9
09182133,Valley,09,Bayern,3204,1644,1560,329,194,135,383,201,182,10.3,6.1,4.2,12.0,6.3,5.7
09182134,Waakirchen,09,Bayern,5661,2815,2846,631,345,286,328,183,145,11.1,6.1,5.1,5.8,3.2,2.6
09182136,Warngau,09,Bayern,3831,1934,1897,432,254,178,265,151,114,11.3,6.6,4.6,6.9,3.9,3.0
09182137,Weyarn,09,Bayern,3494,1765,1729,379,222,157,323,164,159,10.8,6.4,4.5,9.2,4.7,4.6
09183112,Ampfing,09,Bayern,6297,3201,3096,639,396,243,668,408,260,10.1,6.3,3.9,10.6,6.5,4.1
09183113,Aschau a.Inn,09,Bayern,3231,1732,1499,273,164,109,262,154,108,8.4,5.1,3.4,8.1,4.8,3.3
09183114,"Buchbach, M",09,Bayern,3098,1573,1525,360,209,151,411,243,168,11.6,6.7,4.9,13.3,7.8,5.4
09183119,"Haag i.OB, M",09,Bayern,6399,3194,3205,723,409,314,735,438,297,11.3,6.4,4.9,11.5,6.8,4.6
09183127,Mettenheim,09,Bayern,3481,1764,1717,385,217,168,178,109,69,11.1,6.2,4.8,5.1,3.1,2.0
09183128,"Mühldorf a.Inn, St",09,Bayern,19068,9460,9608,1913,1155,758,2944,1781,1163,10.0,6.1,4.0,15.4,9.3,6.1
09183135,Obertaufkirchen,09,Bayern,2555,1331,1224,283,183,100,170,98,72,11.1,7.2,3.9,6.7,3.8,2.8
09183144,Schwindegg,09,Bayern,3532,1776,1756,359,217,142,332,193,139,10.2,6.1,4.0,9.4,5.5,3.9
09183148,"Waldkraiburg, St",09,Bayern,22917,11366,11551,2369,1447,922,1862,1182,680,10.3,6.3,4.0,8.1,5.2,3.0
09183120,Heldenstein,09,Bayern,2518,1244,1274,261,153,108,166,107,59,10.4,6.1,4.3,6.6,4.2,2.3
09183138,Rattenkirchen,09,Bayern,969,498,471,120,74,46,69,36,33,12.4,7.6,4.7,7.1,3.7,3.4
09183118,"Gars a.Inn, M",09,Bayern,3871,1957,1914,305,180,125,346,189,157,7.9,4.6,3.2,8.9,4.9,4.1
09183147,Unterreit,09,Bayern,1715,893,822,199,107,92,148,69,79,11.6,6.2,5.4,8.6,4.0,4.6
09183123,Kirchdorf,09,Bayern,1339,675,664,170,104,66,167,89,78,12.7,7.8,4.9,12.5,6.6,5.8
09183140,Reichertsheim,09,Bayern,1652,861,791,198,129,69,154,87,67,12.0,7.8,4.2,9.3,5.3,4.1
09183122,Jettenbach,09,Bayern,731,370,361,65,34,31,61,31,30,8.9,4.7,4.2,8.3,4.2,4.1
09183124,"Kraiburg a.Inn, M",09,Bayern,4037,2041,1996,428,257,171,338,224,114,10.6,6.4,4.2,8.4,5.5,2.8
09183145,Taufkirchen,09,Bayern,1367,682,685,153,97,56,101,52,49,11.2,7.1,4.1,7.4,3.8,3.6
09183115,Egglkofen,09,Bayern,1185,590,595,140,83,57,90,55,35,11.8,7.0,4.8,7.6,4.6,3.0
09183129,"Neumarkt-Sankt Veit, St",09,Bayern,6101,3074,3027,657,399,258,499,313,186,10.8,6.5,4.2,8.2,5.1,3.0
09183125,Lohkirchen,09,Bayern,733,393,340,72,52,20,63,34,29,9.8,7.1,2.7,8.6,4.6,4.0
09183132,Oberbergkirchen,09,Bayern,1653,861,792,167,114,53,91,54,37,10.1,6.9,3.2,5.5,3.3,2.2
09183143,Schönberg,09,Bayern,1008,523,485,93,68,25,65,47,18,9.2,6.7,2.5,6.4,4.7,1.8
09183151,Zangberg,09,Bayern,1106,552,554,98,57,41,73,31,42,8.9,5.2,3.7,6.6,2.8,3.8
09183134,Oberneukirchen,09,Bayern,843,456,387,99,56,43,48,29,19,11.7,6.6,5.1,5.7,3.4,2.3
09183136,Polling,09,Bayern,3310,1678,1632,370,243,127,289,177,112,11.2,7.3,3.8,8.7,5.3,3.4
09183116,Erharting,09,Bayern,947,480,467,85,53,32,124,72,52,9.0,5.6,3.4,13.1,7.6,5.5
09183130,Niederbergkirchen,09,Bayern,1203,582,621,142,90,52,88,54,34,11.8,7.5,4.3,7.3,4.5,2.8
09183131,Niedertaufkirchen,09,Bayern,1339,741,598,147,92,55,78,39,39,11.0,6.9,4.1,5.8,2.9,2.9
09183126,Maitenbeth,09,Bayern,1989,1029,960,209,123,86,133,82,51,10.5,6.2,4.3,6.7,4.1,2.6
09183139,Rechtmehring,09,Bayern,1840,922,918,189,104,85,155,97,58,10.3,5.7,4.6,8.4,5.3,3.2
09184112,Aschheim,09,Bayern,8778,4530,4248,761,413,348,1633,755,878,8.7,4.7,4.0,18.6,8.6,10.0
09184113,Baierbrunn,09,Bayern,3228,1616,1612,243,167,76,234,142,92,7.5,5.2,2.4,7.2,4.4,2.9
09184114,Brunnthal,09,Bayern,5311,2755,2556,527,272,255,745,392,353,9.9,5.1,4.8,14.0,7.4,6.6
09184118,Feldkirchen,09,Bayern,7190,3621,3569,624,340,284,824,435,389,8.7,4.7,3.9,11.5,6.1,5.4
09184119,"Garching b.München, St",09,Bayern,16812,8679,8133,1783,1011,772,3778,2340,1438,10.6,6.0,4.6,22.5,13.9,8.6
09184120,Gräfelfing,09,Bayern,13596,6518,7078,1118,711,407,2690,1542,1148,8.2,5.2,3.0,19.8,11.3,8.4
09184121,Grasbrunn,09,Bayern,6721,3297,3424,586,337,249,559,321,238,8.7,5.0,3.7,8.3,4.8,3.5
09184122,Grünwald,09,Bayern,11342,5415,5927,842,545,297,1919,1105,814,7.4,4.8,2.6,16.9,9.7,7.2
09184123,Haar,09,Bayern,20513,10000,10513,1926,985,941,1775,945,830,9.4,4.8,4.6,8.7,4.6,4.0
09184127,Höhenkirchen-Siegertsbrunn,09,Bayern,10567,5178,5389,848,488,360,558,304,254,8.0,4.6,3.4,5.3,2.9,2.4
09184129,Hohenbrunn,09,Bayern,8811,4371,4440,683,406,277,977,508,469,7.8,4.6,3.1,11.1,5.8,5.3
09184130,Ismaning,09,Bayern,16372,8056,8316,1521,834,687,2290,1221,1069,9.3,5.1,4.2,14.0,7.5,6.5
09184131,Kirchheim b.München,09,Bayern,12981,6471,6510,1192,700,492,1534,808,726,9.2,5.4,3.8,11.8,6.2,5.6
09184132,Neuried,09,Bayern,8565,4199,4366,729,427,302,678,392,286,8.5,5.0,3.5,7.9,4.6,3.3
09184134,Oberhaching,09,Bayern,13371,6690,6681,1116,667,449,1454,812,642,8.3,5.0,3.4,10.9,6.1,4.8
09184135,Oberschleißheim,09,Bayern,11596,5840,5756,1118,574,544,1433,617,816,9.6,4.9,4.7,12.4,5.3,7.0
09184136,Ottobrunn,09,Bayern,21295,10291,11004,2008,1158,850,3223,1634,1589,9.4,5.4,4.0,15.1,7.7,7.5
09184137,Aying,09,Bayern,5074,2576,2498,489,241,248,376,194,182,9.6,4.7,4.9,7.4,3.8,3.6
09184138,Planegg,09,Bayern,10526,4998,5528,1006,595,411,1733,982,751,9.6,5.7,3.9,16.5,9.3,7.1
09184139,Pullach i.Isartal,09,Bayern,8978,4315,4663,627,388,239,789,455,334,7.0,4.3,2.7,8.8,5.1,3.7
09184140,Putzbrunn,09,Bayern,6503,3198,3305,608,350,258,591,360,231,9.3,5.4,4.0,9.1,5.5,3.6
09184141,Sauerlach,09,Bayern,7705,3909,3796,607,357,250,603,320,283,7.9,4.6,3.2,7.8,4.2,3.7
09184142,Schäftlarn,09,Bayern,5643,2766,2877,447,284,163,383,219,164,7.9,5.0,2.9,6.8,3.9,2.9
09184144,Straßlach-Dingharting,09,Bayern,3132,1564,1568,227,142,85,275,180,95,7.2,4.5,2.7,8.8,5.7,3.0
09184145,Taufkirchen,09,Bayern,17947,8661,9286,1789,1011,778,1255,711,544,10.0,5.6,4.3,7.0,4.0,3.0
09184146,Neubiberg,09,Bayern,14010,7494,6516,1007,633,374,842,460,382,7.2,4.5,2.7,6.0,3.3,2.7
09184147,Unterföhring,09,Bayern,10948,5476,5472,996,504,492,2313,1064,1249,9.1,4.6,4.5,21.1,9.7,11.4
09184148,Unterhaching,09,Bayern,24437,11842,12595,2187,1134,1053,2310,1198,1112,8.9,4.6,4.3,9.5,4.9,4.6
09184149,"Unterschleißheim, St",09,Bayern,28051,14054,13997,2657,1407,1250,2468,1360,1108,9.5,5.0,4.5,8.8,4.8,3.9
09185113,Aresing,09,Bayern,2745,1402,1343,325,188,137,144,89,55,11.8,6.8,5.0,5.2,3.2,2.0
09185125,"Burgheim, M",09,Bayern,4637,2379,2258,467,292,175,329,222,107,10.1,6.3,3.8,7.1,4.8,2.3
09185127,Ehekirchen,09,Bayern,3698,1874,1824,439,258,181,288,158,130,11.9,7.0,4.9,7.8,4.3,3.5
09185139,Karlshuld,09,Bayern,5540,2770,2770,595,384,211,451,302,149,10.7,6.9,3.8,8.1,5.5,2.7
09185140,Karlskron,09,Bayern,4888,2476,2412,432,285,147,309,198,111,8.8,5.8,3.0,6.3,4.1,2.3
09185149,"Neuburg a.d.Donau, GKSt",09,Bayern,29182,14674,14508,3153,1898,1255,3258,2058,1200,10.8,6.5,4.3,11.2,7.1,4.1
09185150,Oberhausen,09,Bayern,2829,1411,1418,294,177,117,449,159,290,10.4,6.3,4.1,15.9,5.6,10.3
09185153,"Rennertshofen, M",09,Bayern,4857,2444,2413,469,282,187,319,180,139,9.7,5.8,3.9,6.6,3.7,2.9
09185158,"Schrobenhausen, St",09,Bayern,16753,8217,8536,1827,1127,700,1898,1217,681,10.9,6.7,4.2,11.3,7.3,4.1
09185163,Königsmoos,09,Bayern,4619,2328,2291,548,346,202,343,194,149,11.9,7.5,4.4,7.4,4.2,3.2
09185168,Weichering,09,Bayern,2434,1247,1187,261,162,99,153,94,59,10.7,6.7,4.1,6.3,3.9,2.4
09185118,Bergheim,09,Bayern,1877,944,933,180,109,71,75,40,35,9.6,5.8,3.8,4.0,2.1,1.9
09185157,Rohrenfels,09,Bayern,1496,781,715,163,115,48,120,73,47,10.9,7.7,3.2,8.0,4.9,3.1
09185116,Berg im Gau,09,Bayern,1255,659,596,153,90,63,124,71,53,12.2,7.2,5.0,9.9,5.7,4.2
09185123,Brunnen,09,Bayern,1656,836,820,189,126,63,111,76,35,11.4,7.6,3.8,6.7,4.6,2.1
09185131,Gachenbach,09,Bayern,2392,1218,1174,303,196,107,314,187,127,12.7,8.2,4.5,13.1,7.8,5.3
09185143,Langenmosen,09,Bayern,1550,792,758,210,129,81,219,110,109,13.5,8.3,5.2,14.1,7.1,7.0
09185166,Waidhofen,09,Bayern,2246,1128,1118,237,133,104,140,64,76,10.6,5.9,4.6,6.2,2.8,3.4
09186113,Baar-Ebenhausen,09,Bayern,5181,2677,2504,490,306,184,226,151,75,9.5,5.9,3.6,4.4,2.9,1.4
09186125,Gerolsbach,09,Bayern,3429,1745,1684,367,231,136,249,163,86,10.7,6.7,4.0,7.3,4.8,2.5
09186128,"Hohenwart, M",09,Bayern,4569,2350,2219,459,305,154,362,215,147,10.0,6.7,3.4,7.9,4.7,3.2
09186132,Jetzendorf,09,Bayern,2995,1493,1502,316,176,140,185,106,79,10.6,5.9,4.7,6.2,3.5,2.6
09186137,"Manching, M",09,Bayern,12317,6253,6064,1191,707,484,768,476,292,9.7,5.7,3.9,6.2,3.9,2.4
09186139,Münchsmünster,09,Bayern,2990,1550,1440,310,194,116,115,78,37,10.4,6.5,3.9,3.8,2.6,1.2
09186143,"Pfaffenhofen a.d.Ilm, St",09,Bayern,25226,12560,12666,2641,1556,1085,2826,1759,1067,10.5,6.2,4.3,11.2,7.0,4.2
09186146,Reichertshausen,09,Bayern,5018,2535,2483,516,311,205,312,176,136,10.3,6.2,4.1,6.2,3.5,2.7
09186149,Rohrbach,09,Bayern,5936,2942,2994,572,353,219,394,253,141,9.6,5.9,3.7,6.6,4.3,2.4
09186151,Scheyern,09,Bayern,4862,2485,2377,478,291,187,355,205,150,9.8,6.0,3.8,7.3,4.2,3.1
09186152,Schweitenkirchen,09,Bayern,5184,2734,2450,569,319,250,522,261,261,11.0,6.2,4.8,10.1,5.0,5.0
09186158,"Vohburg a.d.Donau, St",09,Bayern,8120,4220,3900,731,448,283,665,454,211,9.0,5.5,3.5,8.2,5.6,2.6
09186162,"Wolnzach, M",09,Bayern,11355,5777,5578,1135,683,452,1228,782,446,10.0,6.0,4.0,10.8,6.9,3.9
09186116,Ernsgaden,09,Bayern,1573,806,767,156,91,65,98,60,38,9.9,5.8,4.1,6.2,3.8,2.4
09186122,"Geisenfeld, St",09,Bayern,10930,5776,5154,1084,664,420,887,515,372,9.9,6.1,3.8,8.1,4.7,3.4
09186126,Hettenshausen,09,Bayern,2110,1116,994,198,119,79,159,82,77,9.4,5.6,3.7,7.5,3.9,3.6
09186130,Ilmmünster,09,Bayern,2127,1061,1066,210,118,92,92,57,35,9.9,5.5,4.3,4.3,2.7,1.6
09186144,Pörnbach,09,Bayern,2140,1120,1020,199,127,72,140,96,44,9.3,5.9,3.4,6.5,4.5,2.1
09186147,"Reichertshofen, M",09,Bayern,8066,4125,3941,755,461,294,585,360,225,9.4,5.7,3.6,7.3,4.5,2.8
09187113,Amerang,09,Bayern,3707,1851,1856,435,257,178,386,218,168,11.7,6.9,4.8,10.4,5.9,4.5
09187114,Aschau i.Chiemgau,09,Bayern,5647,2690,2957,557,356,201,636,392,244,9.9,6.3,3.6,11.3,6.9,4.3
09187116,Babensham,09,Bayern,2999,1521,1478,291,170,121,149,85,64,9.7,5.7,4.0,5.0,2.8,2.1
09187117,"Bad Aibling, St",09,Bayern,18407,8881,9526,1927,1123,804,1999,1055,944,10.5,6.1,4.4,10.9,5.7,5.1
09187118,Bernau a.Chiemsee,09,Bayern,6811,3499,3312,622,361,261,535,308,227,9.1,5.3,3.8,7.9,4.5,3.3
09187120,Brannenburg,09,Bayern,5692,2778,2914,584,359,225,551,354,197,10.3,6.3,4.0,9.7,6.2,3.5
09187122,"Bruckmühl, M",09,Bayern,16439,8308,8131,1653,934,719,1323,779,544,10.1,5.7,4.4,8.0,4.7,3.3
09187124,Edling,09,Bayern,4522,2293,2229,496,271,225,391,196,195,11.0,6.0,5.0,8.6,4.3,4.3
09187125,Eggstätt,09,Bayern,2915,1427,1488,324,192,132,293,183,110,11.1,6.6,4.5,10.1,6.3,3.8
09187126,Eiselfing,09,Bayern,2995,1522,1473,353,192,161,295,155,140,11.8,6.4,5.4,9.8,5.2,4.7
09187128,"Bad Endorf, M",09,Bayern,8240,3988,4252,933,519,414,905,525,380,11.3,6.3,5.0,11.0,6.4,4.6
09187129,Bad Feilnbach,09,Bayern,8001,3993,4008,846,515,331,737,447,290,10.6,6.4,4.1,9.2,5.6,3.6
09187130,Feldkirchen-Westerham,09,Bayern,10710,5456,5254,1117,673,444,895,540,355,10.4,6.3,4.1,8.4,5.0,3.3
09187131,Flintsbach a.Inn,09,Bayern,3036,1484,1552,353,201,152,251,125,126,11.6,6.6,5.0,8.3,4.1,4.2
09187132,Frasdorf,09,Bayern,3086,1541,1545,368,221,147,229,141,88,11.9,7.2,4.8,7.4,4.6,2.9
09187134,Griesstätt,09,Bayern,2681,1353,1328,316,171,145,222,129,93,11.8,6.4,5.4,8.3,4.8,3.5
09187137,Großkarolinenfeld,09,Bayern,7306,3631,3675,789,478,311,377,225,152,10.8,6.5,4.3,5.2,3.1,2.1
09187142,Schechen,09,Bayern,4833,2466,2367,557,353,204,349,207,142,11.5,7.3,4.2,7.2,4.3,2.9
09187148,Kiefersfelden,09,Bayern,6775,3335,3440,580,369,211,462,318,144,8.6,5.4,3.1,6.8,4.7,2.1
09187150,"Kolbermoor, St",09,Bayern,18252,8921,9331,2025,1142,883,1836,1002,834,11.1,6.3,4.8,10.1,5.5,4.6
09187154,"Neubeuern, M",09,Bayern,4380,2147,2233,513,327,186,425,264,161,11.7,7.5,4.2,9.7,6.0,3.7
09187156,Nußdorf a.Inn,09,Bayern,2667,1305,1362,300,190,110,291,169,122,11.2,7.1,4.1,10.9,6.3,4.6
09187157,Oberaudorf,09,Bayern,5033,2429,2604,497,305,192,546,363,183,9.9,6.1,3.8,10.8,7.2,3.6
09187162,"Prien a.Chiemsee, M",09,Bayern,10725,5063,5662,1092,664,428,1615,947,668,10.2,6.2,4.0,15.1,8.8,6.2
09187163,Prutting,09,Bayern,2675,1328,1347,333,198,135,294,167,127,12.4,7.4,5.0,11.0,6.2,4.7
09187165,Raubling,09,Bayern,11585,5801,5784,1339,768,571,1235,758,477,11.6,6.6,4.9,10.7,6.5,4.1
09187167,Riedering,09,Bayern,5551,2731,2820,659,406,253,611,333,278,11.9,7.3,4.6,11.0,6.0,5.0
09187168,Rimsting,09,Bayern,3859,1809,2050,418,269,149,310,181,129,10.8,7.0,3.9,8.0,4.7,3.3
09187169,Rohrdorf,09,Bayern,5663,2855,2808,621,351,270,519,301,218,11.0,6.2,4.8,9.2,5.3,3.8
09187172,Samerberg,09,Bayern,2811,1404,1407,292,170,122,242,132,110,10.4,6.0,4.3,8.6,4.7,3.9
09187174,Söchtenau,09,Bayern,2637,1344,1293,310,194,116,194,109,85,11.8,7.4,4.4,7.4,4.1,3.2
09187176,Soyen,09,Bayern,2796,1411,1385,313,170,143,225,137,88,11.2,6.1,5.1,8.0,4.9,3.1
09187177,Stephanskirchen,09,Bayern,10186,4802,5384,1021,607,414,929,609,320,10.0,6.0,4.1,9.1,6.0,3.1
09187179,Tuntenhausen,09,Bayern,7063,3612,3451,767,442,325,611,377,234,10.9,6.3,4.6,8.7,5.3,3.3
09187181,Vogtareuth,09,Bayern,3173,1619,1554,296,159,137,179,92,87,9.3,5.0,4.3,5.6,2.9,2.7
09187182,"Wasserburg a.Inn, St",09,Bayern,12846,6504,6342,1314,649,665,1771,954,817,10.2,5.1,5.2,13.8,7.4,6.4
09187121,Breitbrunn a.Chiemsee,09,Bayern,1568,756,812,157,108,49,110,67,43,10.0,6.9,3.1,7.0,4.3,2.7
09187123,Chiemsee,09,Bayern,232,107,125,13,8,5,41,22,19,5.6,3.4,2.2,17.7,9.5,8.2
09187138,Gstadt a.Chiemsee,09,Bayern,1155,583,572,116,64,52,95,59,36,10.0,5.5,4.5,8.2,5.1,3.1
09187139,Halfing,09,Bayern,2700,1345,1355,296,176,120,256,149,107,11.0,6.5,4.4,9.5,5.5,4.0
09187145,Höslwang,09,Bayern,1286,667,619,149,95,54,152,80,72,11.6,7.4,4.2,11.8,6.2,5.6
09187173,Schonstett,09,Bayern,1354,698,656,151,74,77,102,62,40,11.2,5.5,5.7,7.5,4.6,3.0
09187164,Ramerberg,09,Bayern,1373,692,681,150,79,71,106,57,49,10.9,5.8,5.2,7.7,4.2,3.6
09187170,Rott a.Inn,09,Bayern,4025,2043,1982,429,252,177,522,340,182,10.7,6.3,4.4,13.0,8.4,4.5
09187159,Pfaffing,09,Bayern,3963,2032,1931,417,250,167,346,191,155,10.5,6.3,4.2,8.7,4.8,3.9
09187186,Albaching,09,Bayern,1714,871,843,201,108,93,177,83,94,11.7,6.3,5.4,10.3,4.8,5.5
09188113,Berg,09,Bayern,8264,4080,4184,735,452,283,591,341,250,8.9,5.5,3.4,7.2,4.1,3.0
09188117,Andechs,09,Bayern,3527,1778,1749,382,211,171,374,199,175,10.8,6.0,4.8,10.6,5.6,5.0
09188118,Feldafing,09,Bayern,4333,2095,2238,370,224,146,344,185,159,8.5,5.2,3.4,7.9,4.3,3.7
09188120,Gauting,09,Bayern,20268,9821,10447,1868,1105,763,1491,886,605,9.2,5.5,3.8,7.4,4.4,3.0
09188121,Gilching,09,Bayern,18340,9067,9273,1914,1069,845,1919,1168,751,10.4,5.8,4.6,10.5,6.4,4.1
09188124,Herrsching a.Ammersee,09,Bayern,10400,4833,5567,1083,629,454,1113,624,489,10.4,6.0,4.4,10.7,6.0,4.7
09188126,Inning a.Ammersee,09,Bayern,4515,2297,2218,397,232,165,427,242,185,8.8,5.1,3.7,9.5,5.4,4.1
09188127,Krailling,09,Bayern,7666,3693,3973,611,354,257,622,358,264,8.0,4.6,3.4,8.1,4.7,3.4
09188132,Seefeld,09,Bayern,7333,3629,3704,744,412,332,715,399,316,10.1,5.6,4.5,9.8,5.4,4.3
09188137,Pöcking,09,Bayern,5755,2793,2962,547,324,223,495,284,211,9.5,5.6,3.9,8.6,4.9,3.7
09188139,"Starnberg, St",09,Bayern,22939,10759,12180,2311,1336,975,2909,1614,1295,10.1,5.8,4.3,12.7,7.0,5.6
09188141,Tutzing,09,Bayern,9893,4750,5143,902,550,352,887,497,390,9.1,5.6,3.6,9.0,5.0,3.9
09188144,Weßling,09,Bayern,5381,2709,2672,463,297,166,611,391,220,8.6,5.5,3.1,11.4,7.3,4.1
09188145,Wörthsee,09,Bayern,5007,2468,2539,464,297,167,336,204,132,9.3,5.9,3.3,6.7,4.1,2.6
09189111,Altenmarkt a.d.Alz,09,Bayern,4181,2066,2115,432,253,179,345,195,150,10.3,6.1,4.3,8.3,4.7,3.6
09189114,Chieming,09,Bayern,4827,2319,2508,486,280,206,461,288,173,10.1,5.8,4.3,9.6,6.0,3.6
09189115,Engelsberg,09,Bayern,2574,1309,1265,264,163,101,203,120,83,10.3,6.3,3.9,7.9,4.7,3.2
09189118,Fridolfing,09,Bayern,4147,2104,2043,433,261,172,423,257,166,10.4,6.3,4.1,10.2,6.2,4.0
09189119,Grabenstätt,09,Bayern,4340,2113,2227,466,280,186,922,685,237,10.7,6.5,4.3,21.2,15.8,5.5
09189120,"Grassau, M",09,Bayern,6743,3350,3393,706,449,257,525,324,201,10.5,6.7,3.8,7.8,4.8,3.0
09189124,Inzell,09,Bayern,4622,2303,2319,522,314,208,437,277,160,11.3,6.8,4.5,9.5,6.0,3.5
09189127,Kirchanschöring,09,Bayern,3249,1646,1603,398,253,145,301,173,128,12.2,7.8,4.5,9.3,5.3,3.9
09189130,Nußdorf,09,Bayern,2504,1267,1237,229,121,108,137,80,57,9.1,4.8,4.3,5.5,3.2,2.3
09189134,Palling,09,Bayern,3460,1795,1665,388,247,141,268,175,93,11.2,7.1,4.1,7.7,5.1,2.7
09189135,Petting,09,Bayern,2321,1218,1103,261,166,95,187,106,81,11.2,7.2,4.1,8.1,4.6,3.5
09189139,Reit im Winkl,09,Bayern,2361,1180,1181,243,162,81,275,198,77,10.3,6.9,3.4,11.6,8.4,3.3
09189140,Ruhpolding,09,Bayern,7010,3484,3526,712,449,263,627,387,240,10.2,6.4,3.8,8.9,5.5,3.4
09189141,Schleching,09,Bayern,1783,894,889,191,124,67,121,74,47,10.7,7.0,3.8,6.8,4.2,2.6
09189142,Schnaitsee,09,Bayern,3557,1816,1741,398,230,168,287,159,128,11.2,6.5,4.7,8.1,4.5,3.6
09189143,Seeon-Seebruck,09,Bayern,4558,2284,2274,519,318,201,519,291,228,11.4,7.0,4.4,11.4,6.4,5.0
09189145,Siegsdorf,09,Bayern,8422,4174,4248,906,525,381,752,470,282,10.8,6.2,4.5,8.9,5.6,3.3
09189148,Surberg,09,Bayern,3340,1665,1675,363,205,158,142,78,64,10.9,6.1,4.7,4.3,2.3,1.9
09189149,Tacherting,09,Bayern,5717,2871,2846,618,364,254,414,228,186,10.8,6.4,4.4,7.2,4.0,3.3
09189152,"Tittmoning, St",09,Bayern,5818,2946,2872,521,339,182,467,311,156,9.0,5.8,3.1,8.0,5.3,2.7
09189154,"Traunreut, St",09,Bayern,20799,10234,10565,2110,1141,969,1676,962,714,10.1,5.5,4.7,8.1,4.6,3.4
09189155,"Traunstein, GKSt",09,Bayern,19642,9364,10278,2229,1247,982,4008,2305,1703,11.3,6.3,5.0,20.4,11.7,8.7
09189157,"Trostberg, St",09,Bayern,11073,5411,5662,1182,663,519,1113,661,452,10.7,6.0,4.7,10.1,6.0,4.1
09189159,Übersee,09,Bayern,4989,2446,2543,576,343,233,513,316,197,11.5,6.9,4.7,10.3,6.3,3.9
09189160,Unterwössen,09,Bayern,3472,1706,1766,325,204,121,218,142,76,9.4,5.9,3.5,6.3,4.1,2.2
09189113,Bergen,09,Bayern,4893,2387,2506,470,277,193,299,177,122,9.6,5.7,3.9,6.1,3.6,2.5
09189161,Vachendorf,09,Bayern,1827,877,950,187,112,75,86,52,34,10.2,6.1,4.1,4.7,2.8,1.9
09189129,Marquartstein,09,Bayern,3291,1580,1711,270,178,92,295,187,108,8.2,5.4,2.8,9.0,5.7,3.3
09189146,Staudach-Egerndach,09,Bayern,1147,581,566,119,77,42,90,62,28,10.4,6.7,3.7,7.8,5.4,2.4
09189126,Kienberg,09,Bayern,1381,693,688,159,98,61,103,65,38,11.5,7.1,4.4,7.5,4.7,2.8
09189133,Obing,09,Bayern,4114,1986,2128,493,284,209,553,325,228,12.0,6.9,5.1,13.4,7.9,5.5
09189137,Pittenhart,09,Bayern,1782,891,891,207,133,74,100,56,44,11.6,7.5,4.2,5.6,3.1,2.5
09189150,Taching a.See,09,Bayern,2021,987,1034,174,118,56,118,66,52,8.6,5.8,2.8,5.8,3.3,2.6
09189162,"Waging a.See, M",09,Bayern,6684,3293,3391,758,445,313,707,435,272,11.3,6.7,4.7,10.6,6.5,4.1
09189165,Wonneberg,09,Bayern,1513,759,754,198,116,82,101,53,48,13.1,7.7,5.4,6.7,3.5,3.2
09190115,Bernried am Starnberger See,09,Bayern,2251,1058,1193,219,123,96,220,128,92,9.7,5.5,4.3,9.8,5.7,4.1
09190130,Hohenpeißenberg,09,Bayern,3769,1897,1872,423,249,174,305,172,133,11.2,6.6,4.6,8.1,4.6,3.5
09190138,Pähl,09,Bayern,2374,1184,1190,251,140,111,215,117,98,10.6,5.9,4.7,9.1,4.9,4.1
09190139,"Peißenberg, M",09,Bayern,12516,6117,6399,1451,853,598,1037,649,388,11.6,6.8,4.8,8.3,5.2,3.1
09190140,"Peiting, M",09,Bayern,11334,5791,5543,1210,698,512,1240,734,506,10.7,6.2,4.5,10.9,6.5,4.5
09190141,"Penzberg, St",09,Bayern,16234,7876,8358,1522,862,660,1459,816,643,9.4,5.3,4.1,9.0,5.0,4.0
09190142,Polling,09,Bayern,3307,1634,1673,351,214,137,275,185,90,10.6,6.5,4.1,8.3,5.6,2.7
09190144,Raisting,09,Bayern,2298,1186,1112,242,155,87,161,100,61,10.5,6.7,3.8,7.0,4.4,2.7
09190148,"Schongau, St",09,Bayern,12291,6190,6101,1348,735,613,1428,835,593,11.0,6.0,5.0,11.6,6.8,4.8
09190157,"Weilheim i.OB, St",09,Bayern,22184,10693,11491,2354,1334,1020,3374,2064,1310,10.6,6.0,4.6,15.2,9.3,5.9
09190158,Wessobrunn,09,Bayern,2191,1127,1064,256,136,120,153,87,66,11.7,6.2,5.5,7.0,4.0,3.0
09190159,Wielenbach,09,Bayern,3171,1622,1549,329,202,127,153,103,50,10.4,6.4,4.0,4.8,3.2,1.6
09190111,Altenstadt,09,Bayern,3330,1694,1636,372,221,151,257,152,105,11.2,6.6,4.5,7.7,4.6,3.2
09190129,Hohenfurch,09,Bayern,1547,802,745,180,102,78,87,52,35,11.6,6.6,5.0,5.6,3.4,2.3
09190133,Ingenried,09,Bayern,1019,511,508,98,56,42,45,34,11,9.6,5.5,4.1,4.4,3.3,1.1
09190149,Schwabbruck,09,Bayern,948,483,465,110,63,47,94,58,36,11.6,6.6,5.0,9.9,6.1,3.8
09190151,Schwabsoien,09,Bayern,1337,675,662,130,64,66,85,43,42,9.7,4.8,4.9,6.4,3.2,3.1
09190114,Bernbeuren,09,Bayern,2391,1249,1142,244,149,95,152,89,63,10.2,6.2,4.0,6.4,3.7,2.6
09190118,Burggen,09,Bayern,1688,858,830,186,127,59,121,75,46,11.0,7.5,3.5,7.2,4.4,2.7
09190113,Antdorf,09,Bayern,1288,656,632,116,63,53,77,37,40,9.0,4.9,4.1,6.0,2.9,3.1
09190126,Habach,09,Bayern,1151,566,585,139,88,51,102,71,31,12.1,7.6,4.4,8.9,6.2,2.7
09190136,Obersöchering,09,Bayern,1529,792,737,195,132,63,74,52,22,12.8,8.6,4.1,4.8,3.4,1.4
09190153,Sindelsdorf,09,Bayern,1199,596,603,101,51,50,57,33,24,8.4,4.3,4.2,4.8,2.8,2.0
09190120,Eberfing,09,Bayern,1381,694,687,183,117,66,147,84,63,13.3,8.5,4.8,10.6,6.1,4.6
09190121,Eglfing,09,Bayern,1037,520,517,111,61,50,54,24,30,10.7,5.9,4.8,5.2,2.3,2.9
09190131,Huglfing,09,Bayern,2725,1342,1383,254,154,100,184,100,84,9.3,5.7,3.7,6.8,3.7,3.1
09190135,Oberhausen,09,Bayern,2063,990,1073,214,141,73,123,80,43,10.4,6.8,3.5,6.0,3.9,2.1
09190117,Böbing,09,Bayern,1850,962,888,206,127,79,132,77,55,11.1,6.9,4.3,7.1,4.2,3.0
09190145,Rottenbuch,09,Bayern,1781,913,868,167,105,62,120,71,49,9.4,5.9,3.5,6.7,4.0,2.8
09190132,Iffeldorf,09,Bayern,2572,1292,1280,244,146,98,197,128,69,9.5,5.7,3.8,7.7,5.0,2.7
09190152,Seeshaupt,09,Bayern,3196,1497,1699,302,193,109,446,248,198,9.4,6.0,3.4,14.0,7.8,6.2
09190143,Prem,09,Bayern,872,422,450,94,59,35,94,55,39,10.8,6.8,4.0,10.8,6.3,4.5
09190154,Steingaden,09,Bayern,2744,1379,1365,323,210,113,293,196,97,11.8,7.7,4.1,10.7,7.1,3.5
09190160,Wildsteig,09,Bayern,1338,706,632,140,97,43,45,25,20,10.5,7.2,3.2,3.4,1.9,1.5
09261000,Landshut,09,Bayern,69211,33513,35698,6824,3950,2874,9370,6043,3327,9.9,5.7,4.2,13.5,8.7,4.8
09262000,Passau,09,Bayern,50566,23945,26621,5748,4041,1707,9273,6514,2759,11.4,8.0,3.4,18.3,12.9,5.5
09263000,Straubing,09,Bayern,46806,23519,23287,4993,3074,1919,6666,4163,2503,10.7,6.6,4.1,14.2,8.9,5.3
09271111,Aholming,09,Bayern,2298,1159,1139,254,161,93,115,75,40,11.1,7.0,4.0,5.0,3.3,1.7
09271113,Auerbach,09,Bayern,2111,1058,1053,235,147,88,175,96,79,11.1,7.0,4.2,8.3,4.5,3.7
09271116,Bernried,09,Bayern,4700,2351,2349,461,305,156,209,130,79,9.8,6.5,3.3,4.4,2.8,1.7
09271119,"Deggendorf, GKSt",09,Bayern,32189,15738,16451,3442,2123,1319,4519,2895,1624,10.7,6.6,4.1,14.0,9.0,5.0
09271122,Grafling,09,Bayern,2749,1363,1386,293,208,85,170,118,52,10.7,7.6,3.1,6.2,4.3,1.9
09271125,"Hengersberg, M",09,Bayern,7476,3715,3761,726,458,268,847,584,263,9.7,6.1,3.6,11.3,7.8,3.5
09271127,Iggensbach,09,Bayern,2092,1060,1032,176,126,50,89,66,23,8.4,6.0,2.4,4.3,3.2,1.1
09271128,Künzing,09,Bayern,3138,1547,1591,277,196,81,185,126,59,8.8,6.2,2.6,5.9,4.0,1.9
09271132,"Metten, M",09,Bayern,4219,2048,2171,371,257,114,297,196,101,8.8,6.1,2.7,7.0,4.6,2.4
09271138,Niederalteich,09,Bayern,1714,860,854,146,85,61,82,58,24,8.5,5.0,3.6,4.8,3.4,1.4
09271140,Offenberg,09,Bayern,3314,1647,1667,330,217,113,170,123,47,10.0,6.5,3.4,5.1,3.7,1.4
09271141,"Osterhofen, St",09,Bayern,11602,5804,5798,1108,730,378,1065,695,370,9.6,6.3,3.3,9.2,6.0,3.2
09271146,"Plattling, St",09,Bayern,12913,6453,6460,1338,814,524,1727,996,731,10.4,6.3,4.1,13.4,7.7,5.7
09271151,Stephansposching,09,Bayern,3092,1572,1520,243,160,83,104,62,42,7.9,5.2,2.7,3.4,2.0,1.4
09271153,"Winzer, M",09,Bayern,3831,1916,1915,364,267,97,179,136,43,9.5,7.0,2.5,4.7,3.5,1.1
09271123,Grattersdorf,09,Bayern,1262,609,653,143,98,45,62,42,20,11.3,7.8,3.6,4.9,3.3,1.6
09271126,Hunding,09,Bayern,1176,603,573,127,88,39,35,22,13,10.8,7.5,3.3,3.0,1.9,1.1
09271130,Lalling,09,Bayern,1545,781,764,152,99,53,102,74,28,9.8,6.4,3.4,6.6,4.8,1.8
09271148,Schaufling,09,Bayern,1502,727,775,141,85,56,92,65,27,9.4,5.7,3.7,6.1,4.3,1.8
09271139,Oberpöring,09,Bayern,1131,578,553,107,70,37,55,37,18,9.5,6.2,3.3,4.9,3.3,1.6
09271143,Otzing,09,Bayern,1932,951,981,197,126,71,89,58,31,10.2,6.5,3.7,4.6,3.0,1.6
09271152,Wallerfing,09,Bayern,1314,660,654,139,96,43,94,64,30,10.6,7.3,3.3,7.2,4.9,2.3
09271118,Buchhofen,09,Bayern,888,459,429,95,63,32,58,35,23,10.7,7.1,3.6,6.5,3.9,2.6
09271135,Moos,09,Bayern,2221,1128,1093,225,139,86,197,119,78,10.1,6.3,3.9,8.9,5.4,3.5
09271114,Außernzell,09,Bayern,1391,694,697,144,100,44,57,42,15,10.4,7.2,3.2,4.1,3.0,1.1
09271149,"Schöllnach, M",09,Bayern,4796,2370,2426,471,324,147,337,234,103,9.8,6.8,3.1,7.0,4.9,2.1
09272118,"Freyung, St",09,Bayern,7194,3511,3683,697,475,222,1117,761,356,9.7,6.6,3.1,15.5,10.6,4.9
09272120,"Grafenau, St",09,Bayern,8313,4123,4190,817,546,271,911,633,278,9.8,6.6,3.3,11.0,7.6,3.3
09272121,Grainet,09,Bayern,2391,1178,1213,263,171,92,121,88,33,11.0,7.2,3.8,5.1,3.7,1.4
09272122,Haidmühle,09,Bayern,1341,674,667,120,85,35,76,61,15,8.9,6.3,2.6,5.7,4.5,1.1
09272127,Hohenau,09,Bayern,3311,1659,1652,386,269,117,202,139,63,11.7,8.1,3.5,6.1,4.2,1.9
09272129,Jandelsbrunn,09,Bayern,3317,1676,1641,392,245,147,170,103,67,11.8,7.4,4.4,5.1,3.1,2.0
09272134,Mauth,09,Bayern,2306,1158,1148,263,197,66,182,137,45,11.4,8.5,2.9,7.9,5.9,2.0
09272136,Neureichenau,09,Bayern,4379,2202,2177,468,328,140,396,257,139,10.7,7.5,3.2,9.0,5.9,3.2
09272140,Ringelai,09,Bayern,1899,951,948,187,113,74,124,91,33,9.8,6.0,3.9,6.5,4.8,1.7
09272141,"Röhrnbach, M",09,Bayern,4382,2223,2159,458,316,142,503,331,172,10.5,7.2,3.2,11.5,7.6,3.9
09272142,Saldenburg,09,Bayern,1947,958,989,211,160,51,124,96,28,10.8,8.2,2.6,6.4,4.9,1.4
09272143,Sankt Oswald-Riedlhütte,09,Bayern,2848,1373,1475,295,215,80,160,102,58,10.4,7.5,2.8,5.6,3.6,2.0
09272146,Neuschönau,09,Bayern,2259,1160,1099,234,175,59,197,157,40,10.4,7.7,2.6,8.7,6.9,1.8
09272149,Spiegelau,09,Bayern,3864,1901,1963,407,272,135,335,234,101,10.5,7.0,3.5,8.7,6.1,2.6
09272151,"Waldkirchen, St",09,Bayern,10283,5060,5223,1283,872,411,1304,884,420,12.5,8.5,4.0,12.7,8.6,4.1
09272116,Eppenschlag,09,Bayern,982,481,501,101,73,28,79,44,35,10.3,7.4,2.9,8.0,4.5,3.6
09272128,Innernzell,09,Bayern,1561,807,754,169,112,57,106,83,23,10.8,7.2,3.7,6.8,5.3,1.5
09272145,Schöfweg,09,Bayern,1306,679,627,156,115,41,121,87,34,11.9,8.8,3.1,9.3,6.7,2.6
09272147,"Schönberg, M",09,Bayern,3862,1908,1954,367,258,109,354,264,90,9.5,6.7,2.8,9.2,6.8,2.3
09272126,Hinterschmiding,09,Bayern,2425,1218,1207,273,198,75,162,121,41,11.3,8.2,3.1,6.7,5.0,1.7
09272139,Philippsreut,09,Bayern,660,334,326,61,42,19,54,38,16,9.2,6.4,2.9,8.2,5.8,2.4
09272150,Thurmansbang,09,Bayern,2361,1198,1163,247,170,77,160,112,48,10.5,7.2,3.3,6.8,4.7,2.0
09272152,Zenting,09,Bayern,1178,609,569,123,92,31,98,73,25,10.4,7.8,2.6,8.3,6.2,2.1
09272119,Fürsteneck,09,Bayern,882,445,437,86,52,34,45,27,18,9.8,5.9,3.9,5.1,3.1,2.0
09272138,"Perlesreut, M",09,Bayern,2871,1435,1436,320,209,111,267,155,112,11.1,7.3,3.9,9.3,5.4,3.9
09273111,"Abensberg, St",09,Bayern,13540,6958,6582,1419,866,553,1674,1136,538,10.5,6.4,4.1,12.4,8.4,4.0
09273116,"Bad Abbach, M",09,Bayern,12208,5988,6220,1141,688,453,748,468,280,9.3,5.6,3.7,6.1,3.8,2.3
09273137,"Kelheim, St",09,Bayern,16270,8195,8075,1663,1032,631,1822,1162,660,10.2,6.3,3.9,11.2,7.1,4.1
09273147,"Mainburg, St",09,Bayern,14855,7499,7356,1653,1000,653,1497,965,532,11.1,6.7,4.4,10.1,6.5,3.6
09273152,"Neustadt a.d.Donau, St",09,Bayern,13670,6967,6703,1457,848,609,1310,820,490,10.7,6.2,4.5,9.6,6.0,3.6
09273159,"Painten, M",09,Bayern,2235,1148,1087,267,177,90,199,117,82,11.9,7.9,4.0,8.9,5.2,3.7
09273164,"Riedenburg, St",09,Bayern,5813,2961,2852,635,407,228,727,463,264,10.9,7.0,3.9,12.5,8.0,4.5
09273165,"Rohr i.NB, M",09,Bayern,3369,1733,1636,324,209,115,189,124,65,9.6,6.2,3.4,5.6,3.7,1.9
09273121,"Essing, M",09,Bayern,1032,503,529,114,69,45,94,55,39,11.0,6.7,4.4,9.1,5.3,3.8
09273133,Ihrlerstein,09,Bayern,4226,2152,2074,372,256,116,166,109,57,8.8,6.1,2.7,3.9,2.6,1.3
09273166,Saal a.d.Donau,09,Bayern,5366,2697,2669,565,345,220,710,243,467,10.5,6.4,4.1,13.2,4.5,8.7
09273175,Teugn,09,Bayern,1689,832,857,209,132,77,184,119,65,12.4,7.8,4.6,10.9,7.0,3.8
09273125,Hausen,09,Bayern,2063,1048,1015,236,141,95,122,74,48,11.4,6.8,4.6,5.9,3.6,2.3
09273127,Herrngiersdorf,09,Bayern,1224,651,573,135,99,36,103,78,25,11.0,8.1,2.9,8.4,6.4,2.0
09273141,"Langquaid, M",09,Bayern,5452,2781,2671,527,342,185,434,285,149,9.7,6.3,3.4,8.0,5.2,2.7
09273119,Biburg,09,Bayern,1193,624,569,137,98,39,45,29,16,11.5,8.2,3.3,3.8,2.4,1.3
09273139,Kirchdorf,09,Bayern,910,481,429,107,61,46,45,23,22,11.8,6.7,5.1,4.9,2.5,2.4
09273172,"Siegenburg, M",09,Bayern,3668,1864,1804,351,216,135,334,228,106,9.6,5.9,3.7,9.1,6.2,2.9
09273177,Train,09,Bayern,1872,957,915,172,114,58,99,60,39,9.2,6.1,3.1,5.3,3.2,2.1
09273181,Wildenberg,09,Bayern,1388,711,677,144,91,53,77,45,32,10.4,6.6,3.8,5.5,3.2,2.3
09273113,Aiglsbach,09,Bayern,1759,913,846,161,115,46,60,32,28,9.2,6.5,2.6,3.4,1.8,1.6
09273115,Attenhofen,09,Bayern,1319,665,654,158,110,48,65,37,28,12.0,8.3,3.6,4.9,2.8,2.1
09273163,Elsendorf,09,Bayern,2138,1122,1016,204,131,73,128,81,47,9.5,6.1,3.4,6.0,3.8,2.2
09273178,Volkenschwand,09,Bayern,1706,856,850,190,130,60,147,101,46,11.1,7.6,3.5,8.6,5.9,2.7
09274111,Adlkofen,09,Bayern,4078,2092,1986,448,281,167,252,161,91,11.0,6.9,4.1,6.2,3.9,2.2
09274113,"Altdorf, M",09,Bayern,11158,5579,5579,1307,763,544,1175,740,435,11.7,6.8,4.9,10.5,6.6,3.9
09274120,Bodenkirchen,09,Bayern,5243,2687,2556,551,324,227,367,219,148,10.5,6.2,4.3,7.0,4.2,2.8
09274121,Buch a.Erlbach,09,Bayern,3739,1878,1861,356,209,147,293,201,92,9.5,5.6,3.9,7.8,5.4,2.5
09274124,Eching,09,Bayern,3903,2009,1894,408,236,172,596,331,265,10.5,6.0,4.4,15.3,8.5,6.8
09274126,"Ergolding, M",09,Bayern,12193,6003,6190,1337,807,530,2539,1231,1308,11.0,6.6,4.3,20.8,10.1,10.7
09274128,"Essenbach, M",09,Bayern,11804,6013,5791,1211,701,510,993,550,443,10.3,5.9,4.3,8.4,4.7,3.8
09274134,"Geisenhausen, M",09,Bayern,6896,3470,3426,723,469,254,560,357,203,10.5,6.8,3.7,8.1,5.2,2.9
09274141,Hohenthann,09,Bayern,4063,2099,1964,449,291,158,303,176,127,11.1,7.2,3.9,7.5,4.3,3.1
09274146,Kumhausen,09,Bayern,5351,2693,2658,555,340,215,521,317,204,10.4,6.4,4.0,9.7,5.9,3.8
09274153,Neufahrn i.NB,09,Bayern,4017,2029,1988,359,213,146,275,180,95,8.9,5.3,3.6,6.8,4.5,2.4
09274156,Niederaichbach,09,Bayern,3975,2120,1855,409,241,168,212,106,106,10.3,6.1,4.2,5.3,2.7,2.7
09274172,"Pfeffenhausen, M",09,Bayern,4932,2596,2336,514,324,190,327,200,127,10.4,6.6,3.9,6.6,4.1,2.6
09274176,"Rottenburg a.d.Laaber, St",09,Bayern,7827,3933,3894,909,549,360,893,556,337,11.6,7.0,4.6,11.4,7.1,4.3
09274182,Tiefenbach,09,Bayern,3792,1904,1888,342,224,118,208,131,77,9.0,5.9,3.1,5.5,3.5,2.0
09274184,"Vilsbiburg, St",09,Bayern,11535,5740,5795,1185,713,472,1271,831,440,10.3,6.2,4.1,11.0,7.2,3.8
09274185,Vilsheim,09,Bayern,2491,1289,1202,256,145,111,131,89,42,10.3,5.8,4.5,5.3,3.6,1.7
09274194,Bruckberg,09,Bayern,5336,2698,2638,611,355,256,489,260,229,11.5,6.7,4.8,9.2,4.9,4.3
09274119,Bayerbach b.Ergoldsbach,09,Bayern,1809,915,894,207,140,67,157,108,49,11.4,7.7,3.7,8.7,6.0,2.7
09274127,"Ergoldsbach, M",09,Bayern,7709,3893,3816,784,509,275,565,347,218,10.2,6.6,3.6,7.3,4.5,2.8
09274132,Furth,09,Bayern,3529,1773,1756,378,237,141,272,164,108,10.7,6.7,4.0,7.7,4.6,3.1
09274165,Obersüßbach,09,Bayern,1734,895,839,175,92,83,115,61,54,10.1,5.3,4.8,6.6,3.5,3.1
09274187,Weihmichl,09,Bayern,2483,1285,1198,268,155,113,117,58,59,10.8,6.2,4.6,4.7,2.3,2.4
09274174,Postau,09,Bayern,1620,817,803,165,108,57,113,76,37,10.2,6.7,3.5,7.0,4.7,2.3
09274188,Weng,09,Bayern,1434,740,694,150,98,52,76,50,26,10.5,6.8,3.6,5.3,3.5,1.8
09274191,Wörth a.d.Isar,09,Bayern,2837,1489,1348,310,188,122,349,217,132,10.9,6.6,4.3,12.3,7.6,4.7
09274112,Aham,09,Bayern,1958,996,962,192,108,84,91,55,36,9.8,5.5,4.3,4.6,2.8,1.8
09274135,Gerzen,09,Bayern,1824,912,912,227,144,83,200,128,72,12.4,7.9,4.6,11.0,7.0,3.9
09274145,Kröning,09,Bayern,2011,1001,1010,194,129,65,87,55,32,9.6,6.4,3.2,4.3,2.7,1.6
09274179,Schalkham,09,Bayern,860,448,412,93,55,38,53,28,25,10.8,6.4,4.4,6.2,3.3,2.9
09274114,Altfraunhofen,09,Bayern,2317,1192,1125,202,119,83,166,106,60,8.7,5.1,3.6,7.2,4.6,2.6
09274118,Baierbach,09,Bayern,791,418,373,85,60,25,62,33,29,10.7,7.6,3.2,7.8,4.2,3.7
09274154,Neufraunhofen,09,Bayern,1072,554,518,135,68,67,101,38,63,12.6,6.3,6.2,9.4,3.5,5.9
09274183,"Velden, M",09,Bayern,6903,3614,3289,714,413,301,550,352,198,10.3,6.0,4.4,8.0,5.1,2.9
09274193,Wurmsham,09,Bayern,1353,694,659,124,68,56,68,33,35,9.2,5.0,4.1,5.0,2.4,2.6
09275111,Aicha vorm Wald,09,Bayern,2435,1258,1177,305,221,84,171,132,39,12.5,9.1,3.4,7.0,5.4,1.6
09275114,Aldersbach,09,Bayern,4224,2100,2124,392,275,117,321,232,89,9.3,6.5,2.8,7.6,5.5,2.1
09275116,Bad Füssing,09,Bayern,6994,3333,3661,614,404,210,1153,730,423,8.8,5.8,3.0,16.5,10.4,6.0
09275118,Breitenberg,09,Bayern,2083,1035,1048,238,164,74,180,133,47,11.4,7.9,3.6,8.6,6.4,2.3
09275119,Büchlberg,09,Bayern,4104,2050,2054,490,316,174,367,245,122,11.9,7.7,4.2,8.9,6.0,3.0
09275120,"Eging a.See, M",09,Bayern,4269,2107,2162,528,351,177,664,368,296,12.4,8.2,4.1,15.6,8.6,6.9
09275121,Fürstenstein,09,Bayern,3399,1723,1676,362,232,130,267,174,93,10.7,6.8,3.8,7.9,5.1,2.7
09275122,"Fürstenzell, M",09,Bayern,7987,3929,4058,799,504,295,696,427,269,10.0,6.3,3.7,8.7,5.3,3.4
09275124,"Bad Griesbach i.Rottal, St",09,Bayern,8859,4351,4508,903,545,358,924,589,335,10.2,6.2,4.0,10.4,6.6,3.8
09275125,Haarbach,09,Bayern,2587,1290,1297,253,161,92,161,103,58,9.8,6.2,3.6,6.2,4.0,2.2
09275126,"Hauzenberg, St",09,Bayern,11523,5715,5808,1297,844,453,1114,764,350,11.3,7.3,3.9,9.7,6.6,3.0
09275127,"Hofkirchen, M",09,Bayern,3581,1823,1758,342,225,117,239,160,79,9.6,6.3,3.3,6.7,4.5,2.2
09275128,"Hutthurm, M",09,Bayern,5914,2933,2981,682,438,244,765,497,268,11.5,7.4,4.1,12.9,8.4,4.5
09275130,Kirchham,09,Bayern,2195,1071,1124,198,129,69,208,134,74,9.0,5.9,3.1,9.5,6.1,3.4
09275131,"Kößlarn, M",09,Bayern,1891,944,947,186,116,70,110,61,49,9.8,6.1,3.7,5.8,3.2,2.6
09275133,Neuburg a.Inn,09,Bayern,4394,2193,2201,449,283,166,356,220,136,10.2,6.4,3.8,8.1,5.0,3.1
09275134,Neuhaus a.Inn,09,Bayern,3415,1740,1675,345,229,116,294,195,99,10.1,6.7,3.4,8.6,5.7,2.9
09275135,Neukirchen vorm Wald,09,Bayern,2748,1371,1377,300,186,114,225,122,103,10.9,6.8,4.1,8.2,4.4,3.7
09275137,"Obernzell, M",09,Bayern,3795,1924,1871,396,260,136,353,240,113,10.4,6.9,3.6,9.3,6.3,3.0
09275138,"Ortenburg, M",09,Bayern,7090,3535,3555,715,457,258,669,370,299,10.1,6.4,3.6,9.4,5.2,4.2
09275141,"Pocking, St",09,Bayern,15499,7564,7935,1740,1027,713,1352,861,491,11.2,6.6,4.6,8.7,5.6,3.2
09275144,Ruderting,09,Bayern,3128,1551,1577,340,210,130,275,172,103,10.9,6.7,4.2,8.8,5.5,3.3
09275145,"Ruhstorf a.d.Rott, M",09,Bayern,6944,3467,3477,702,449,253,511,319,192,10.1,6.5,3.6,7.4,4.6,2.8
09275146,Salzweg,09,Bayern,6813,3379,3434,661,416,245,395,257,138,9.7,6.1,3.6,5.8,3.8,2.0
09275148,Sonnen,09,Bayern,1432,724,708,193,129,64,91,66,25,13.5,9.0,4.5,6.4,4.6,1.7
09275149,Tettenweis,09,Bayern,1700,859,841,170,103,67,142,74,68,10.0,6.1,3.9,8.4,4.4,4.0
09275150,Thyrnau,09,Bayern,4343,2137,2206,403,245,158,404,235,169,9.3,5.6,3.6,9.3,5.4,3.9
09275151,Tiefenbach,09,Bayern,6713,3346,3367,737,485,252,472,318,154,11.0,7.2,3.8,7.0,4.7,2.3
09275153,"Untergriesbach, M",09,Bayern,6004,3008,2996,675,443,232,475,307,168,11.2,7.4,3.9,7.9,5.1,2.8
09275154,"Vilshofen an der Donau, St",09,Bayern,16251,8054,8197,1756,1189,567,1741,1200,541,10.8,7.3,3.5,10.7,7.4,3.3
09275156,"Wegscheid, M",09,Bayern,5579,2830,2749,631,408,223,586,381,205,11.3,7.3,4.0,10.5,6.8,3.7
09275159,"Windorf, M",09,Bayern,4762,2384,2378,520,357,163,339,222,117,10.9,7.5,3.4,7.1,4.7,2.5
09275152,"Tittling, M",09,Bayern,4008,1909,2099,389,266,123,423,306,117,9.7,6.6,3.1,10.6,7.6,2.9
09275112,"Aidenbach, M",09,Bayern,2963,1455,1508,269,176,93,216,138,78,9.1,5.9,3.1,7.3,4.7,2.6
09275117,Beutelsbach,09,Bayern,1110,558,552,118,74,44,62,31,31,10.6,6.7,4.0,5.6,2.8,2.8
09275132,Malching,09,Bayern,1247,616,631,126,79,47,56,33,23,10.1,6.3,3.8,4.5,2.6,1.8
09275143,"Rotthalmünster, M",09,Bayern,4885,2358,2527,460,275,185,393,259,134,9.4,5.6,3.8,8.0,5.3,2.7
09275160,Witzmannsberg,09,Bayern,1468,723,745,145,104,41,58,34,24,9.9,7.1,2.8,4.0,2.3,1.6
09276113,Arnbruck,09,Bayern,1939,966,973,227,152,75,189,126,63,11.7,7.8,3.9,9.7,6.5,3.2
09276115,Bayerisch Eisenstein,09,Bayern,1007,528,479,59,51,8,62,52,10,5.9,5.1,0.8,6.2,5.2,1.0
09276116,Bischofsmais,09,Bayern,3172,1630,1542,303,223,80,231,167,64,9.6,7.0,2.5,7.3,5.3,2.0
09276117,"Bodenmais, M",09,Bayern,3397,1678,1719,348,228,120,483,347,136,10.2,6.7,3.5,14.2,10.2,4.0
09276118,Böbrach,09,Bayern,1646,827,819,142,104,38,64,48,16,8.6,6.3,2.3,3.9,2.9,1.0
09276120,Drachselsried,09,Bayern,2428,1200,1228,294,212,82,191,147,44,12.1,8.7,3.4,7.9,6.1,1.8
09276121,Frauenau,09,Bayern,2679,1309,1370,234,168,66,193,141,52,8.7,6.3,2.5,7.2,5.3,1.9
09276122,Geiersthal,09,Bayern,2189,1111,1078,215,145,70,235,147,88,9.8,6.6,3.2,10.7,6.7,4.0
09276126,Kirchberg i.Wald,09,Bayern,4325,2202,2123,467,326,141,325,223,102,10.8,7.5,3.3,7.5,5.2,2.4
09276127,Kirchdorf i.Wald,09,Bayern,2131,1074,1057,192,147,45,111,76,35,9.0,6.9,2.1,5.2,3.6,1.6
09276128,Kollnburg,09,Bayern,2787,1430,1357,337,241,96,158,109,49,12.1,8.6,3.4,5.7,3.9,1.8
09276129,Langdorf,09,Bayern,1847,920,927,180,124,56,71,42,29,9.7,6.7,3.0,3.8,2.3,1.6
09276130,Lindberg,09,Bayern,2362,1178,1184,239,175,64,123,86,37,10.1,7.4,2.7,5.2,3.6,1.6
09276134,Patersdorf,09,Bayern,1672,811,861,176,128,48,85,49,36,10.5,7.7,2.9,5.1,2.9,2.2
09276135,Prackenbach,09,Bayern,2676,1326,1350,284,197,87,130,91,39,10.6,7.4,3.3,4.9,3.4,1.5
09276138,"Regen, St",09,Bayern,10855,5400,5455,1000,673,327,1383,992,391,9.2,6.2,3.0,12.7,9.1,3.6
09276139,Rinchnach,09,Bayern,3080,1553,1527,307,202,105,150,99,51,10.0,6.6,3.4,4.9,3.2,1.7
09276143,"Teisnach, M",09,Bayern,2879,1474,1405,300,213,87,280,190,90,10.4,7.4,3.0,9.7,6.6,3.1
09276144,"Viechtach, St",09,Bayern,8060,4027,4033,841,549,292,1182,767,415,10.4,6.8,3.6,14.7,9.5,5.1
09276148,"Zwiesel, St",09,Bayern,9407,4596,4811,909,654,255,998,725,273,9.7,7.0,2.7,10.6,7.7,2.9
09276111,Achslach,09,Bayern,902,474,428,97,74,23,54,36,18,10.8,8.2,2.5,6.0,4.0,2.0
09276123,Gotteszell,09,Bayern,1199,584,615,122,94,28,26,21,5,10.2,7.8,2.3,2.2,1.8,0.4
09276142,"Ruhmannsfelden, M",09,Bayern,2100,1054,1046,212,147,65,264,188,76,10.1,7.0,3.1,12.6,9.0,3.6
09276146,Zachenberg,09,Bayern,2073,1050,1023,209,147,62,96,71,25,10.1,7.1,3.0,4.6,3.4,1.2
09277111,"Arnstorf, M",09,Bayern,6654,3494,3160,664,439,225,814,552,262,10.0,6.6,3.4,12.2,8.3,3.9
09277114,Dietersburg,09,Bayern,3128,1565,1563,286,191,95,159,99,60,9.1,6.1,3.0,5.1,3.2,1.9
09277116,"Eggenfelden, St",09,Bayern,13456,6598,6858,1555,911,644,2017,1237,780,11.6,6.8,4.8,15.0,9.2,5.8
09277117,Egglham,09,Bayern,2369,1205,1164,241,173,68,155,115,40,10.2,7.3,2.9,6.5,4.9,1.7
09277121,"Gangkofen, M",09,Bayern,6433,3201,3232,713,451,262,550,324,226,11.1,7.0,4.1,8.5,5.0,3.5
09277124,Hebertsfelden,09,Bayern,3623,1756,1867,394,251,143,293,152,141,10.9,6.9,3.9,8.1,4.2,3.9
09277126,Johanniskirchen,09,Bayern,2447,1234,1213,264,163,101,228,143,85,10.8,6.7,4.1,9.3,5.8,3.5
09277127,Julbach,09,Bayern,2328,1172,1156,230,169,61,136,89,47,9.9,7.3,2.6,5.8,3.8,2.0
09277128,Kirchdorf a.Inn,09,Bayern,5389,2691,2698,503,338,165,295,189,106,9.3,6.3,3.1,5.5,3.5,2.0
09277134,Mitterskirchen,09,Bayern,2027,1018,1009,228,151,77,168,109,59,11.2,7.4,3.8,8.3,5.4,2.9
09277138,"Pfarrkirchen, St",09,Bayern,12297,5941,6356,1260,759,501,1476,932,544,10.2,6.2,4.1,12.0,7.6,4.4
09277139,Postmünster,09,Bayern,2288,1116,1172,213,126,87,144,80,64,9.3,5.5,3.8,6.3,3.5,2.8
09277142,Roßbach,09,Bayern,2973,1514,1459,273,180,93,178,102,76,9.2,6.1,3.1,6.0,3.4,2.6
09277144,Schönau,09,Bayern,1973,986,987,240,149,91,205,124,81,12.2,7.6,4.6,10.4,6.3,4.1
09277145,"Simbach a.Inn, St",09,Bayern,9933,4915,5018,872,581,291,1198,792,406,8.8,5.8,2.9,12.1,8.0,4.1
09277149,"Triftern, M",09,Bayern,5235,2623,2612,512,322,190,316,216,100,9.8,6.2,3.6,6.0,4.1,1.9
09277151,Unterdietfurt,09,Bayern,2079,1084,995,237,150,87,130,72,58,11.4,7.2,4.2,6.3,3.5,2.8
09277152,Wittibreut,09,Bayern,2052,1041,1011,204,136,68,126,90,36,9.9,6.6,3.3,6.1,4.4,1.8
09277153,"Wurmannsquick, M",09,Bayern,3597,1807,1790,392,244,148,335,189,146,10.9,6.8,4.1,9.3,5.3,4.1
09277154,Zeilarn,09,Bayern,2141,1113,1028,204,125,79,126,74,52,9.5,5.8,3.7,5.9,3.5,2.4
09277119,Falkenberg,09,Bayern,3745,1866,1879,454,287,167,273,161,112,12.1,7.7,4.5,7.3,4.3,3.0
09277131,Malgersdorf,09,Bayern,1218,614,604,151,86,65,129,75,54,12.4,7.1,5.3,10.6,6.2,4.4
09277141,Rimbach,09,Bayern,897,434,463,104,69,35,99,53,46,11.6,7.7,3.9,11.0,5.9,5.1
09277122,Geratskirchen,09,Bayern,857,422,435,115,72,43,70,47,23,13.4,8.4,5.0,8.2,5.5,2.7
09277133,"Massing, M",09,Bayern,4013,2020,1993,488,308,180,505,313,192,12.2,7.7,4.5,12.6,7.8,4.8
09277112,Bayerbach,09,Bayern,1624,806,818,180,117,63,109,59,50,11.1,7.2,3.9,6.7,3.6,3.1
09277113,"Bad Birnbach, M",09,Bayern,5678,2772,2906,643,409,234,843,547,296,11.3,7.2,4.1,14.8,9.6,5.2
09277140,Reut,09,Bayern,1698,871,827,169,126,43,65,51,14,10.0,7.4,2.5,3.8,3.0,0.8
09277148,"Tann, M",09,Bayern,3924,1974,1950,363,234,129,309,194,115,9.3,6.0,3.3,7.9,4.9,2.9
09277118,Ering,09,Bayern,1769,857,912,156,105,51,80,54,26,8.8,5.9,2.9,4.5,3.1,1.5
09277147,Stubenberg,09,Bayern,1373,692,681,136,92,44,52,36,16,9.9,6.7,3.2,3.8,2.6,1.2
09278118,"Bogen, St",09,Bayern,9771,4904,4867,1080,678,402,900,584,316,11.1,6.9,4.1,9.2,6.0,3.2
09278121,Feldkirchen,09,Bayern,1981,1042,939,196,120,76,96,63,33,9.9,6.1,3.8,4.8,3.2,1.7
09278123,"Geiselhöring, St",09,Bayern,6870,3476,3394,707,453,254,567,377,190,10.3,6.6,3.7,8.3,5.5,2.8
09278129,Haibach,09,Bayern,2121,1096,1025,220,142,78,140,90,50,10.4,6.7,3.7,6.6,4.2,2.4
09278141,Kirchroth,09,Bayern,3660,1840,1820,411,275,136,257,148,109,11.2,7.5,3.7,7.0,4.0,3.0
09278143,Konzell,09,Bayern,1820,907,913,190,121,69,165,92,73,10.4,6.6,3.8,9.1,5.1,4.0
09278144,Laberweinting,09,Bayern,3404,1768,1636,329,211,118,204,131,73,9.7,6.2,3.5,6.0,3.8,2.1
09278146,Leiblfing,09,Bayern,4188,2094,2094,382,244,138,273,178,95,9.1,5.8,3.3,6.5,4.3,2.3
09278148,"Mallersdorf-Pfaffenberg, M",09,Bayern,6683,3136,3547,593,382,211,546,356,190,8.9,5.7,3.2,8.2,5.3,2.8
09278167,Oberschneiding,09,Bayern,2806,1425,1381,283,167,116,157,86,71,10.1,6.0,4.1,5.6,3.1,2.5
09278170,Parkstetten,09,Bayern,3107,1539,1568,333,198,135,165,94,71,10.7,6.4,4.3,5.3,3.0,2.3
09278178,Rattenberg,09,Bayern,1769,917,852,203,119,84,140,77,63,11.5,6.7,4.7,7.9,4.4,3.6
09278184,Sankt Englmar,09,Bayern,1725,876,849,215,133,82,315,206,109,12.5,7.7,4.8,18.3,11.9,6.3
09278190,Steinach,09,Bayern,3109,1566,1543,329,193,136,253,159,94,10.6,6.2,4.4,8.1,5.1,3.0
09278197,Wiesenfelden,09,Bayern,3712,1904,1808,399,274,125,227,148,79,10.7,7.4,3.4,6.1,4.0,2.1
09278147,Loitzendorf,09,Bayern,614,315,299,70,54,16,25,17,8,11.4,8.8,2.6,4.1,2.8,1.3
09278179,Rattiszell,09,Bayern,1530,808,722,152,112,40,91,61,30,9.9,7.3,2.6,5.9,4.0,2.0
09278189,Stallwang,09,Bayern,1430,747,683,142,95,47,114,87,27,9.9,6.6,3.3,8.0,6.1,1.9
09278116,Ascha,09,Bayern,1597,806,791,165,115,50,69,47,22,10.3,7.2,3.1,4.3,2.9,1.4
09278120,Falkenfels,09,Bayern,1030,513,517,109,73,36,-1,-1,-1,10.6,7.1,3.5,-0.1,,
09278134,Haselbach,09,Bayern,1797,931,866,192,120,72,102,62,40,10.7,6.7,4.0,5.7,3.5,2.2
09278151,"Mitterfels, M",09,Bayern,2609,1305,1304,261,164,97,344,187,157,10.0,6.3,3.7,13.2,7.2,6.0
09278139,Hunderdorf,09,Bayern,3323,1674,1649,393,251,142,233,155,78,11.8,7.6,4.3,7.0,4.7,2.3
09278154,Neukirchen,09,Bayern,1733,910,823,184,111,73,124,86,38,10.6,6.4,4.2,7.2,5.0,2.2
09278198,Windberg,09,Bayern,1051,536,515,98,55,43,45,33,12,9.3,5.2,4.1,4.3,3.1,1.1
09278112,Aholfing,09,Bayern,1813,930,883,204,129,75,93,57,36,11.3,7.1,4.1,5.1,3.1,2.0
09278117,Atting,09,Bayern,1650,815,835,179,121,58,196,102,94,10.8,7.3,3.5,11.9,6.2,5.7
09278172,Perkam,09,Bayern,1528,769,759,141,88,53,37,22,15,9.2,5.8,3.5,2.4,1.4,1.0
09278177,Rain,09,Bayern,2787,1420,1367,303,180,123,179,105,74,10.9,6.5,4.4,6.4,3.8,2.7
09278149,Mariaposching,09,Bayern,1438,714,724,157,87,70,83,43,40,10.9,6.1,4.9,5.8,3.0,2.8
09278159,Niederwinkling,09,Bayern,2607,1308,1299,279,167,112,321,166,155,10.7,6.4,4.3,12.3,6.4,5.9
09278171,Perasdorf,09,Bayern,573,288,285,54,34,20,-1,-1,-1,9.4,5.9,3.5,-0.2,,
09278187,"Schwarzach, M",09,Bayern,2799,1390,1409,265,175,90,253,150,103,9.5,6.3,3.2,9.0,5.4,3.7
09278113,Aiterhofen,09,Bayern,3312,1622,1690,370,247,123,270,172,98,11.2,7.5,3.7,8.2,5.2,3.0
09278182,Salching,09,Bayern,2567,1258,1309,261,184,77,186,99,87,10.2,7.2,3.0,7.2,3.9,3.4
09278140,Irlbach,09,Bayern,1122,554,568,131,87,44,59,43,16,11.7,7.8,3.9,5.3,3.8,1.4
09278192,Straßkirchen,09,Bayern,3170,1580,1590,311,195,116,195,122,73,9.8,6.2,3.7,6.2,3.8,2.3
09279112,"Dingolfing, St",09,Bayern,19145,9951,9194,1927,1092,835,2602,1453,1149,10.1,5.7,4.4,13.6,7.6,6.0
09279113,"Eichendorf, M",09,Bayern,6521,3340,3181,597,371,226,416,253,163,9.2,5.7,3.5,6.4,3.9,2.5
09279115,"Frontenhausen, M",09,Bayern,4649,2414,2235,416,252,164,724,518,206,8.9,5.4,3.5,15.6,11.1,4.4
09279122,"Landau a.d.Isar, St",09,Bayern,13027,6386,6641,1511,856,655,2800,1779,1021,11.6,6.6,5.0,21.5,13.7,7.8
09279124,Loiching,09,Bayern,3508,1827,1681,325,211,114,217,135,82,9.3,6.0,3.2,6.2,3.8,2.3
09279126,Marklkofen,09,Bayern,3681,1912,1769,320,198,122,227,133,94,8.7,5.4,3.3,6.2,3.6,2.6
09279127,Mengkofen,09,Bayern,6053,3149,2904,605,378,227,486,291,195,10.0,6.2,3.8,8.0,4.8,3.2
09279128,Moosthenning,09,Bayern,4903,2563,2340,478,286,192,353,188,165,9.7,5.8,3.9,7.2,3.8,3.4
09279130,Niederviehbach,09,Bayern,2519,1317,1202,241,138,103,168,81,87,9.6,5.5,4.1,6.7,3.2,3.5
09279132,"Pilsting, M",09,Bayern,6499,3267,3232,582,365,217,396,230,166,9.0,5.6,3.3,6.1,3.5,2.6
09279134,"Reisbach, M",09,Bayern,7675,3973,3702,703,442,261,707,391,316,9.2,5.8,3.4,9.2,5.1,4.1
09279135,"Simbach, M",09,Bayern,3774,1942,1832,359,244,115,442,216,226,9.5,6.5,3.0,11.7,5.7,6.0
09279137,"Wallersdorf, M",09,Bayern,6799,3468,3331,622,396,226,442,260,182,9.1,5.8,3.3,6.5,3.8,2.7
09279116,Gottfrieding,09,Bayern,2242,1236,1006,196,123,73,105,65,40,8.7,5.5,3.3,4.7,2.9,1.8
09279125,Mamming,09,Bayern,3109,1624,1485,297,176,121,336,170,166,9.6,5.7,3.9,10.8,5.5,5.3
09361000,Amberg,09,Bayern,41861,20571,21290,4210,2668,1542,5121,3310,1811,10.1,6.4,3.7,12.2,7.9,4.3
09362000,Regensburg,09,Bayern,145465,69969,75496,15385,9845,5540,24620,16158,8462,10.6,6.8,3.8,16.9,11.1,5.8
09363000,Weiden i.d.OPf.,09,Bayern,42055,20052,22003,4300,2753,1547,8309,5543,2766,10.2,6.5,3.7,19.8,13.2,6.6
09371111,Ammerthal,09,Bayern,2098,1083,1015,202,141,61,108,65,43,9.6,6.7,2.9,5.1,3.1,2.0
09371113,"Auerbach i.d.OPf., St",09,Bayern,8940,4390,4550,717,474,243,559,368,191,8.0,5.3,2.7,6.3,4.1,2.1
09371118,Ebermannsdorf,09,Bayern,2453,1260,1193,243,146,97,138,84,54,9.9,6.0,4.0,5.6,3.4,2.2
09371119,Edelsfeld,09,Bayern,1888,931,957,201,131,70,174,109,65,10.6,6.9,3.7,9.2,5.8,3.4
09371120,Ensdorf,09,Bayern,2219,1129,1090,190,127,63,74,49,25,8.6,5.7,2.8,3.3,2.2,1.1
09371121,"Freihung, M",09,Bayern,2642,1354,1288,232,169,63,122,92,30,8.8,6.4,2.4,4.6,3.5,1.1
09371122,Freudenberg,09,Bayern,4195,2110,2085,439,274,165,329,188,141,10.5,6.5,3.9,7.8,4.5,3.4
09371127,"Hirschau, St",09,Bayern,5795,2857,2938,575,376,199,450,298,152,9.9,6.5,3.4,7.8,5.1,2.6
09371129,"Hohenburg, M",09,Bayern,1573,799,774,150,107,43,78,55,23,9.5,6.8,2.7,5.0,3.5,1.5
09371132,"Kastl, M",09,Bayern,2440,1261,1179,227,156,71,163,98,65,9.3,6.4,2.9,6.7,4.0,2.7
09371136,Kümmersbruck,09,Bayern,9750,4838,4912,1049,601,448,563,340,223,10.8,6.2,4.6,5.8,3.5,2.3
09371144,Poppenricht,09,Bayern,3412,1678,1734,347,234,113,131,74,57,10.2,6.9,3.3,3.8,2.2,1.7
09371146,"Rieden, M",09,Bayern,2735,1391,1344,288,203,85,287,199,88,10.5,7.4,3.1,10.5,7.3,3.2
09371148,"Schmidmühlen, M",09,Bayern,2330,1142,1188,220,151,69,132,95,37,9.4,6.5,3.0,5.7,4.1,1.6
09371150,"Schnaittenbach, St",09,Bayern,4188,2099,2089,460,311,149,370,248,122,11.0,7.4,3.6,8.8,5.9,2.9
09371151,"Sulzbach-Rosenberg, St",09,Bayern,19624,9712,9912,1984,1259,725,1868,1177,691,10.1,6.4,3.7,9.5,6.0,3.5
09371154,Ursensollen,09,Bayern,3641,1848,1793,393,236,157,409,223,186,10.8,6.5,4.3,11.2,6.1,5.1
09371156,"Vilseck, St",09,Bayern,5893,2852,3041,506,322,184,390,243,147,8.6,5.5,3.1,6.6,4.1,2.5
09371123,Gebenbach,09,Bayern,895,457,438,80,48,32,62,36,26,8.9,5.4,3.6,6.9,4.0,2.9
09371126,"Hahnbach, M",09,Bayern,4917,2499,2418,509,353,156,318,210,108,10.4,7.2,3.2,6.5,4.3,2.2
09371128,Hirschbach,09,Bayern,1237,621,616,119,70,49,64,27,37,9.6,5.7,4.0,5.2,2.2,3.0
09371135,"Königstein, M",09,Bayern,1697,894,803,151,97,54,156,85,71,8.9,5.7,3.2,9.2,5.0,4.2
09371140,Etzelwang,09,Bayern,1409,692,717,125,84,41,90,50,40,8.9,6.0,2.9,6.4,3.5,2.8
09371141,Neukirchen b.Sulzbach-Rosenberg,09,Bayern,2592,1302,1290,215,142,73,174,117,57,8.3,5.5,2.8,6.7,4.5,2.2
09371157,Weigendorf,09,Bayern,1218,629,589,133,105,28,78,54,24,10.9,8.6,2.3,6.4,4.4,2.0
09371116,Birgland,09,Bayern,1777,944,833,193,128,65,153,87,66,10.9,7.2,3.7,8.6,4.9,3.7
09371131,Illschwang,09,Bayern,2010,995,1015,209,130,79,139,87,52,10.4,6.5,3.9,6.9,4.3,2.6
09372112,Arnschwang,09,Bayern,1946,959,987,202,130,72,143,89,54,10.4,6.7,3.7,7.3,4.6,2.8
09372113,Arrach,09,Bayern,2480,1233,1247,301,224,77,197,155,42,12.1,9.0,3.1,7.9,6.2,1.7
09372115,Blaibach,09,Bayern,1923,951,972,201,145,56,106,73,33,10.5,7.5,2.9,5.5,3.8,1.7
09372116,"Cham, St",09,Bayern,16529,8141,8388,1850,1187,663,3371,2346,1025,11.2,7.2,4.0,20.4,14.2,6.2
09372117,Chamerau,09,Bayern,2608,1316,1292,261,161,100,170,121,49,10.0,6.2,3.8,6.5,4.6,1.9
09372124,"Eschlkam, M",09,Bayern,3347,1670,1677,331,233,98,174,134,40,9.9,7.0,2.9,5.2,4.0,1.2
09372126,"Furth im Wald, St",09,Bayern,8910,4455,4455,890,626,264,922,641,281,10.0,7.0,3.0,10.3,7.2,3.2
09372130,Grafenwiesen,09,Bayern,1522,744,778,152,106,46,96,69,27,10.0,7.0,3.0,6.3,4.5,1.8
09372135,Hohenwarth,09,Bayern,1887,920,967,185,137,48,99,71,28,9.8,7.3,2.5,5.2,3.8,1.5
09372137,"Bad Kötzting, St",09,Bayern,7301,3563,3738,811,529,282,1198,797,401,11.1,7.2,3.9,16.4,10.9,5.5
09372138,"Lam, M",09,Bayern,2641,1293,1348,269,194,75,338,235,103,10.2,7.3,2.8,12.8,8.9,3.9
09372143,Miltach,09,Bayern,2295,1133,1162,213,137,76,177,114,63,9.3,6.0,3.3,7.7,5.0,2.7
09372144,"Neukirchen b.Hl.Blut, M",09,Bayern,3749,1878,1871,389,302,87,312,233,79,10.4,8.1,2.3,8.3,6.2,2.1
09372146,Pemfling,09,Bayern,2217,1115,1102,223,147,76,74,41,33,10.1,6.6,3.4,3.3,1.8,1.5
09372151,Rimbach,09,Bayern,1855,922,933,191,140,51,91,69,22,10.3,7.5,2.7,4.9,3.7,1.2
09372153,"Roding, St",09,Bayern,11682,5816,5866,1163,716,447,1255,798,457,10.0,6.1,3.8,10.7,6.8,3.9
09372154,"Rötz, St",09,Bayern,3460,1775,1685,382,252,130,328,215,113,11.0,7.3,3.8,9.5,6.2,3.3
09372155,Runding,09,Bayern,2295,1108,1187,251,163,88,166,96,70,10.9,7.1,3.8,7.2,4.2,3.1
09372157,Schönthal,09,Bayern,1951,960,991,201,147,54,106,76,30,10.3,7.5,2.8,5.4,3.9,1.5
09372158,Schorndorf,09,Bayern,2687,1341,1346,307,198,109,224,127,97,11.4,7.4,4.1,8.3,4.7,3.6
09372164,Traitsching,09,Bayern,4105,2085,2020,396,264,132,214,134,80,9.6,6.4,3.2,5.2,3.3,1.9
09372168,Waffenbrunn,09,Bayern,2096,1071,1025,222,141,81,95,58,37,10.6,6.7,3.9,4.5,2.8,1.8
09372171,"Waldmünchen, St",09,Bayern,6768,3329,3439,618,451,167,574,405,169,9.1,6.7,2.5,8.5,6.0,2.5
09372175,Willmering,09,Bayern,1991,980,1011,232,149,83,140,87,53,11.7,7.5,4.2,7.0,4.4,2.7
09372177,Zandt,09,Bayern,1864,888,976,175,115,60,-1,-1,-1,9.4,6.2,3.2,-0.1,,
09372178,Lohberg,09,Bayern,1875,946,929,236,179,57,135,105,30,12.6,9.5,3.0,7.2,5.6,1.6
09372163,Tiefenbach,09,Bayern,1969,969,1000,205,144,61,107,78,29,10.4,7.3,3.1,5.4,4.0,1.5
09372165,Treffelstein,09,Bayern,971,513,458,107,69,38,-1,-1,-1,11.0,7.1,3.9,-0.1,,
09372147,Pösing,09,Bayern,988,504,484,94,57,37,58,36,22,9.5,5.8,3.7,5.9,3.6,2.2
09372161,"Stamsried, M",09,Bayern,2191,1145,1046,192,115,77,97,73,24,8.8,5.2,3.5,4.4,3.3,1.1
09372128,Gleißenberg,09,Bayern,905,458,447,89,68,21,51,32,19,9.8,7.5,2.3,5.6,3.5,2.1
09372174,Weiding,09,Bayern,2456,1221,1235,270,175,95,119,70,49,11.0,7.1,3.9,4.8,2.9,2.0
09372149,Reichenbach,09,Bayern,1301,790,511,70,45,25,66,48,18,5.4,3.5,1.9,5.1,3.7,1.4
09372170,Walderbach,09,Bayern,2088,1075,1013,195,126,69,115,73,42,9.3,6.0,3.3,5.5,3.5,2.0
09372167,Zell,09,Bayern,1831,945,886,193,122,71,81,46,35,10.5,6.7,3.9,4.4,2.5,1.9
09372169,Wald,09,Bayern,2842,1456,1386,262,178,84,227,163,64,9.2,6.3,3.0,8.0,5.7,2.3
09372125,"Falkenstein, M",09,Bayern,3257,1627,1630,310,197,113,242,169,73,9.5,6.0,3.5,7.4,5.2,2.2
09372142,Michelsneukirchen,09,Bayern,1746,893,853,187,114,73,101,58,43,10.7,6.5,4.2,5.8,3.3,2.5
09372150,Rettenbach,09,Bayern,1830,929,901,196,136,60,88,63,25,10.7,7.4,3.3,4.8,3.4,1.4
09373112,"Berching, St",09,Bayern,8522,4279,4243,814,536,278,695,453,242,9.6,6.3,3.3,8.2,5.3,2.8
09373113,Berg b.Neumarkt i.d.OPf.,09,Bayern,7556,3835,3721,772,501,271,519,325,194,10.2,6.6,3.6,6.9,4.3,2.6
09373115,"Breitenbrunn, M",09,Bayern,3454,1790,1664,354,239,115,166,106,60,10.2,6.9,3.3,4.8,3.1,1.7
09373119,Deining,09,Bayern,4506,2286,2220,436,281,155,179,115,64,9.7,6.2,3.4,4.0,2.6,1.4
09373121,"Dietfurt a.d.Altmühl, St",09,Bayern,6084,3173,2911,699,465,234,618,426,192,11.5,7.6,3.8,10.2,7.0,3.2
09373126,"Freystadt, St",09,Bayern,8791,4542,4249,984,670,314,700,475,225,11.2,7.6,3.6,8.0,5.4,2.6
09373134,"Hohenfels, M",09,Bayern,2130,1115,1015,175,117,58,124,82,42,8.2,5.5,2.7,5.8,3.8,2.0
09373140,"Lauterhofen, M",09,Bayern,3682,1890,1792,354,235,119,331,212,119,9.6,6.4,3.2,9.0,5.8,3.2
09373143,"Lupburg, M",09,Bayern,2365,1186,1179,295,183,112,155,95,60,12.5,7.7,4.7,6.6,4.0,2.5
09373146,Mühlhausen,09,Bayern,4842,2491,2351,491,327,164,339,247,92,10.1,6.8,3.4,7.0,5.1,1.9
09373147,"Neumarkt i.d.OPf., GKSt",09,Bayern,39333,19066,20267,4010,2538,1472,4683,3045,1638,10.2,6.5,3.7,11.9,7.7,4.2
09373151,"Parsberg, St",09,Bayern,6771,3438,3333,635,409,226,672,455,217,9.4,6.0,3.3,9.9,6.7,3.2
09373155,"Postbauer-Heng, M",09,Bayern,7539,3757,3782,705,458,247,456,276,180,9.4,6.1,3.3,6.0,3.7,2.4
09373156,"Pyrbaum, M",09,Bayern,5702,2834,2868,503,313,190,330,191,139,8.8,5.5,3.3,5.8,3.3,2.4
09373160,Seubersdorf i.d.OPf.,09,Bayern,5124,2579,2545,496,352,144,293,186,107,9.7,6.9,2.8,5.7,3.6,2.1
09373167,"Velburg, St",09,Bayern,5228,2619,2609,608,416,192,488,317,171,11.6,8.0,3.7,9.3,6.1,3.3
09373114,Berngau,09,Bayern,2583,1293,1290,278,186,92,120,80,40,10.8,7.2,3.6,4.6,3.1,1.5
09373153,Pilsach,09,Bayern,2780,1468,1312,306,179,127,198,124,74,11.0,6.4,4.6,7.1,4.5,2.7
09373159,Sengenthal,09,Bayern,3393,2030,1363,287,193,94,490,293,197,8.5,5.7,2.8,14.4,8.6,5.8
09374111,Altenstadt a.d.Waldnaab,09,Bayern,4776,2304,2472,466,299,167,325,204,121,9.8,6.3,3.5,6.8,4.3,2.5
09374118,"Eslarn, M",09,Bayern,2756,1412,1344,239,147,92,195,115,80,8.7,5.3,3.3,7.1,4.2,2.9
09374121,"Floß, M",09,Bayern,3436,1728,1708,322,210,112,219,136,83,9.4,6.1,3.3,6.4,4.0,2.4
09374122,Flossenbürg,09,Bayern,1582,785,797,167,96,71,73,43,30,10.6,6.1,4.5,4.6,2.7,1.9
09374124,"Grafenwöhr, St",09,Bayern,6521,3191,3330,654,400,254,537,340,197,10.0,6.1,3.9,8.2,5.2,3.0
09374133,"Luhe-Wildenau, M",09,Bayern,3424,1742,1682,389,261,128,345,227,118,11.4,7.6,3.7,10.1,6.6,3.4
09374134,"Mantel, M",09,Bayern,2808,1395,1413,285,186,99,112,77,35,10.1,6.6,3.5,4.0,2.7,1.2
09374137,"Moosbach, M",09,Bayern,2450,1208,1242,224,147,77,144,86,58,9.1,6.0,3.1,5.9,3.5,2.4
09374139,"Neustadt a.d.Waldnaab, St",09,Bayern,5840,2858,2982,540,357,183,495,314,181,9.2,6.1,3.1,8.5,5.4,3.1
09374162,"Vohenstrauß, St",09,Bayern,7392,3602,3790,784,510,274,653,416,237,10.6,6.9,3.7,8.8,5.6,3.2
09374164,"Waidhaus, M",09,Bayern,2214,1124,1090,182,107,75,192,105,87,8.2,4.8,3.4,8.7,4.7,3.9
09374165,"Waldthurn, M",09,Bayern,1946,1002,944,204,132,72,111,70,41,10.5,6.8,3.7,5.7,3.6,2.1
09374168,"Windischeschenbach, St",09,Bayern,4991,2494,2497,473,304,169,512,325,187,9.5,6.1,3.4,10.3,6.5,3.7
09374128,Kirchendemenreuth,09,Bayern,852,440,412,64,45,19,38,21,17,7.5,5.3,2.2,4.5,2.5,2.0
09374144,"Parkstein, M",09,Bayern,2331,1199,1132,229,141,88,171,106,65,9.8,6.0,3.8,7.3,4.5,2.8
09374150,Püchersreuth,09,Bayern,1588,808,780,181,105,76,78,46,32,11.4,6.6,4.8,4.9,2.9,2.0
09374158,Störnstein,09,Bayern,1476,728,748,171,102,69,89,53,36,11.6,6.9,4.7,6.0,3.6,2.4
09374160,Theisseil,09,Bayern,1169,597,572,100,67,33,63,32,31,8.6,5.7,2.8,5.4,2.7,2.7
09374148,Trabitz,09,Bayern,1286,646,640,113,70,43,59,36,23,8.8,5.4,3.3,4.6,2.8,1.8
09374149,"Pressath, St",09,Bayern,4338,2111,2227,387,258,129,326,213,113,8.9,5.9,3.0,7.5,4.9,2.6
09374156,Schwarzenbach,09,Bayern,1170,559,611,136,80,56,117,56,61,11.6,6.8,4.8,10.0,4.8,5.2
09374119,Etzenricht,09,Bayern,1610,804,806,146,90,56,60,40,20,9.1,5.6,3.5,3.7,2.5,1.2
09374131,"Kohlberg, M",09,Bayern,1213,624,589,134,93,41,66,38,28,11.0,7.7,3.4,5.4,3.1,2.3
09374166,Weiherhammer,09,Bayern,3851,1905,1946,397,254,143,248,155,93,10.3,6.6,3.7,6.4,4.0,2.4
09374129,"Kirchenthumbach, M",09,Bayern,3261,1676,1585,220,148,72,144,116,28,6.7,4.5,2.2,4.4,3.6,0.9
09374155,Schlammersdorf,09,Bayern,876,452,424,82,57,25,73,48,25,9.4,6.5,2.9,8.3,5.5,2.9
09374163,Vorbach,09,Bayern,1036,527,509,73,38,35,-1,-1,-1,7.0,3.7,3.4,-0.1,,
09374117,"Eschenbach i.d.OPf., St",09,Bayern,3948,1904,2044,307,183,124,288,176,112,7.8,4.6,3.1,7.3,4.5,2.8
09374140,"Neustadt am Kulm, St",09,Bayern,1125,544,581,67,41,26,33,17,16,6.0,3.6,2.3,2.9,1.5,1.4
09374157,Speinshart,09,Bayern,1102,537,565,112,76,36,70,42,28,10.2,6.9,3.3,6.4,3.8,2.5
09374127,Irchenrieth,09,Bayern,1365,671,694,146,83,63,182,146,36,10.7,6.1,4.6,13.3,10.7,2.6
09374146,Pirk,09,Bayern,1819,902,917,158,83,75,42,27,15,8.7,4.6,4.1,2.3,1.5,0.8
09374154,Schirmitz,09,Bayern,1991,954,1037,215,134,81,91,58,33,10.8,6.7,4.1,4.6,2.9,1.7
09374170,Bechtsrieth,09,Bayern,1051,511,540,95,57,38,-1,-1,-1,9.0,5.4,3.6,-0.1,,
09374132,"Leuchtenberg, M",09,Bayern,1172,588,584,119,70,49,69,44,25,10.2,6.0,4.2,5.9,3.8,2.1
09374159,"Tännesberg, M",09,Bayern,1531,785,746,134,92,42,95,66,29,8.8,6.0,2.7,6.2,4.3,1.9
09374123,Georgenberg,09,Bayern,1345,695,650,115,75,40,57,38,19,8.6,5.6,3.0,4.2,2.8,1.4
09374147,"Pleystein, St",09,Bayern,2436,1214,1222,262,162,100,228,132,96,10.8,6.7,4.1,9.4,5.4,3.9
09375117,Barbing,09,Bayern,5335,2711,2624,532,314,218,414,243,171,10.0,5.9,4.1,7.8,4.6,3.2
09375118,"Beratzhausen, M",09,Bayern,5520,2758,2762,562,358,204,346,239,107,10.2,6.5,3.7,6.3,4.3,1.9
09375119,Bernhardswald,09,Bayern,5519,2724,2795,545,364,181,247,159,88,9.9,6.6,3.3,4.5,2.9,1.6
09375143,Hagelstadt,09,Bayern,1967,1012,955,203,126,77,69,55,14,10.3,6.4,3.9,3.5,2.8,0.7
09375148,"Hemau, St",09,Bayern,8908,4584,4324,1020,661,359,791,516,275,11.5,7.4,4.0,8.9,5.8,3.1
09375161,Köfering,09,Bayern,2452,1239,1213,253,144,109,122,63,59,10.3,5.9,4.4,5.0,2.6,2.4
09375165,"Lappersdorf, M",09,Bayern,13215,6418,6797,1222,820,402,654,437,217,9.2,6.2,3.0,4.9,3.3,1.6
09375170,Mintraching,09,Bayern,4818,2388,2430,541,336,205,375,239,136,11.2,7.0,4.3,7.8,5.0,2.8
09375174,"Neutraubling, St",09,Bayern,13431,6574,6857,1579,890,689,2218,1325,893,11.8,6.6,5.1,16.5,9.9,6.6
09375175,"Nittendorf, M",09,Bayern,9279,4579,4700,932,600,332,598,407,191,10.0,6.5,3.6,6.4,4.4,2.1
09375179,Obertraubling,09,Bayern,8153,4094,4059,760,428,332,700,413,287,9.3,5.2,4.1,8.6,5.1,3.5
09375180,Pentling,09,Bayern,5958,2986,2972,593,397,196,445,260,185,10.0,6.7,3.3,7.5,4.4,3.1
09375181,Pettendorf,09,Bayern,3287,1639,1648,310,201,109,141,95,46,9.4,6.1,3.3,4.3,2.9,1.4
09375183,Pfatter,09,Bayern,3204,1616,1588,315,221,94,209,145,64,9.8,6.9,2.9,6.5,4.5,2.0
09375190,"Regenstauf, M",09,Bayern,15831,7851,7980,1540,969,571,1578,1034,544,9.7,6.1,3.6,10.0,6.5,3.4
09375196,"Schierling, M",09,Bayern,7709,3873,3836,780,508,272,629,408,221,10.1,6.6,3.5,8.2,5.3,2.9
09375199,Sinzing,09,Bayern,6922,3475,3447,680,439,241,485,305,180,9.8,6.3,3.5,7.0,4.4,2.6
09375204,Tegernheim,09,Bayern,5370,2631,2739,537,319,218,312,210,102,10.0,5.9,4.1,5.8,3.9,1.9
09375205,Thalmassing,09,Bayern,3360,1667,1693,345,228,117,142,80,62,10.3,6.8,3.5,4.2,2.4,1.8
09375208,Wenzenbach,09,Bayern,8441,4255,4186,811,508,303,419,274,145,9.6,6.0,3.6,5.0,3.2,1.7
09375209,Wiesent,09,Bayern,2520,1279,1241,271,174,97,125,83,42,10.8,6.9,3.8,5.0,3.3,1.7
09375213,Zeitlarn,09,Bayern,5881,2944,2937,574,356,218,272,180,92,9.8,6.1,3.7,4.6,3.1,1.6
09375131,Duggendorf,09,Bayern,1588,804,784,171,121,50,75,43,32,10.8,7.6,3.1,4.7,2.7,2.0
09375153,Holzheim a.Forst,09,Bayern,975,488,487,76,49,27,33,13,20,7.8,5.0,2.8,3.4,1.3,2.1
09375156,"Kallmünz, M",09,Bayern,2848,1407,1441,273,180,93,222,149,73,9.6,6.3,3.3,7.8,5.2,2.6
09375122,Brunn,09,Bayern,1446,736,710,149,97,52,75,38,37,10.3,6.7,3.6,5.2,2.6,2.6
09375127,Deuerling,09,Bayern,2059,1037,1022,208,132,76,101,66,35,10.1,6.4,3.7,4.9,3.2,1.7
09375162,"Laaber, M",09,Bayern,5177,2583,2594,491,337,154,747,330,417,9.5,6.5,3.0,14.4,6.4,8.1
09375184,Pielenhofen,09,Bayern,1534,781,753,188,124,64,110,65,45,12.3,8.1,4.2,7.2,4.2,2.9
09375211,Wolfsegg,09,Bayern,1516,775,741,179,122,57,69,43,26,11.8,8.0,3.8,4.6,2.8,1.7
09375114,Altenthann,09,Bayern,1513,760,753,157,105,52,42,26,16,10.4,6.9,3.4,2.8,1.7,1.1
09375116,Bach a.d.Donau,09,Bayern,1803,934,869,216,146,70,137,92,45,12.0,8.1,3.9,7.6,5.1,2.5
09375130,"Donaustauf, M",09,Bayern,3999,1967,2032,341,222,119,320,196,124,8.5,5.6,3.0,8.0,4.9,3.1
09375120,Brennberg,09,Bayern,1956,988,968,230,155,75,124,78,46,11.8,7.9,3.8,6.3,4.0,2.4
09375210,"Wörth a.d.Donau, St",09,Bayern,4756,2426,2330,501,329,172,586,378,208,10.5,6.9,3.6,12.3,7.9,4.4
09375113,Alteglofsheim,09,Bayern,3187,1593,1594,304,189,115,262,148,114,9.5,5.9,3.6,8.2,4.6,3.6
09375182,Pfakofen,09,Bayern,1612,816,796,178,109,69,89,60,29,11.0,6.8,4.3,5.5,3.7,1.8
09375115,Aufhausen,09,Bayern,1820,921,899,177,120,57,70,50,20,9.7,6.6,3.1,3.8,2.7,1.1
09375171,Mötzing,09,Bayern,1713,813,900,123,74,49,32,20,12,7.2,4.3,2.9,1.9,1.2,0.7
09375191,Riekofen,09,Bayern,784,414,370,62,46,16,47,26,21,7.9,5.9,2.0,6.0,3.3,2.7
09375201,Sünching,09,Bayern,2024,991,1033,194,138,56,159,119,40,9.6,6.8,2.8,7.9,5.9,2.0
09376116,Bodenwöhr,09,Bayern,4233,2126,2107,416,259,157,323,210,113,9.8,6.1,3.7,7.6,5.0,2.7
09376117,"Bruck i.d.OPf., M",09,Bayern,4439,2253,2186,438,287,151,351,208,143,9.9,6.5,3.4,7.9,4.7,3.2
09376119,"Burglengenfeld, St",09,Bayern,12862,6301,6561,1254,786,468,1272,777,495,9.7,6.1,3.6,9.9,6.0,3.8
09376125,Fensterbach,09,Bayern,2366,1227,1139,222,141,81,176,118,58,9.4,6.0,3.4,7.4,5.0,2.5
09376141,"Maxhütte-Haidhof, St",09,Bayern,10941,5482,5459,1089,681,408,979,650,329,10.0,6.2,3.7,8.9,5.9,3.0
09376147,"Neunburg vorm Wald, St",09,Bayern,8233,4228,4005,816,503,313,952,582,370,9.9,6.1,3.8,11.6,7.1,4.5
09376149,"Nittenau, St",09,Bayern,8732,4435,4297,828,533,295,733,499,234,9.5,6.1,3.4,8.4,5.7,2.7
09376150,"Wernberg-Köblitz, M",09,Bayern,5685,2857,2828,561,355,206,685,366,319,9.9,6.2,3.6,12.0,6.4,5.6
09376151,"Oberviechtach, St",09,Bayern,4948,2488,2460,478,302,176,533,342,191,9.7,6.1,3.6,10.8,6.9,3.9
09376159,Schmidgaden,09,Bayern,2879,1475,1404,273,190,83,145,98,47,9.5,6.6,2.9,5.0,3.4,1.6
09376161,"Schwandorf, GKSt",09,Bayern,28481,14181,14300,2803,1831,972,2904,1932,972,9.8,6.4,3.4,10.2,6.8,3.4
09376170,"Teublitz, St",09,Bayern,7299,3627,3672,670,447,223,512,340,172,9.2,6.1,3.1,7.0,4.7,2.4
09376131,Gleiritsch,09,Bayern,660,340,320,69,42,27,-1,-1,-1,10.5,6.4,4.1,-0.2,,
09376148,Niedermurach,09,Bayern,1254,648,606,115,80,35,51,31,20,9.2,6.4,2.8,4.1,2.5,1.6
09376171,Teunz,09,Bayern,1844,926,918,217,149,68,113,81,32,11.8,8.1,3.7,6.1,4.4,1.7
09376178,"Winklarn, M",09,Bayern,1417,712,705,151,104,47,112,83,29,10.7,7.3,3.3,7.9,5.9,2.0
09376112,Altendorf,09,Bayern,891,467,424,82,54,28,61,43,18,9.2,6.1,3.1,6.8,4.8,2.0
09376133,Guteneck,09,Bayern,831,435,396,77,52,25,44,20,24,9.3,6.3,3.0,5.3,2.4,2.9
09376144,"Nabburg, St",09,Bayern,6110,3045,3065,623,396,227,809,505,304,10.2,6.5,3.7,13.2,8.3,5.0
09376162,Schwarzach b.Nabburg,09,Bayern,1449,744,705,126,80,46,39,20,19,8.7,5.5,3.2,2.7,1.4,1.3
09376163,"Schwarzenfeld, M",09,Bayern,6244,3047,3197,611,384,227,484,330,154,9.8,6.1,3.6,7.8,5.3,2.5
09376169,Stulln,09,Bayern,1678,835,843,160,93,67,83,59,24,9.5,5.5,4.0,4.9,3.5,1.4
09376153,"Pfreimd, St",09,Bayern,5412,2742,2670,535,351,184,477,318,159,9.9,6.5,3.4,8.8,5.9,2.9
09376173,Trausnitz,09,Bayern,954,491,463,81,58,23,33,21,12,8.5,6.1,2.4,3.5,2.2,1.3
09376160,"Schönsee, St",09,Bayern,2439,1224,1215,229,163,66,207,161,46,9.4,6.7,2.7,8.5,6.6,1.9
09376167,Stadlern,09,Bayern,523,257,266,28,21,7,-1,-1,-1,5.4,4.0,1.3,-0.2,,
09376176,Weiding,09,Bayern,490,278,212,37,30,7,41,30,11,7.6,6.1,1.4,8.4,6.1,2.2
09376122,Dieterskirchen,09,Bayern,1011,521,490,107,73,34,52,29,23,10.6,7.2,3.4,5.1,2.9,2.3
09376146,"Neukirchen-Balbini, M",09,Bayern,1130,577,553,110,79,31,36,19,17,9.7,7.0,2.7,3.2,1.7,1.5
09376164,"Schwarzhofen, M",09,Bayern,1428,749,679,130,76,54,48,32,16,9.1,5.3,3.8,3.4,2.2,1.1
09376172,Thanstein,09,Bayern,970,505,465,84,57,27,55,32,23,8.7,5.9,2.8,5.7,3.3,2.4
09376168,Steinberg am See,09,Bayern,1883,958,925,189,117,72,170,99,71,10.0,6.2,3.8,9.0,5.3,3.8
09376175,Wackersdorf,09,Bayern,5148,2603,2545,487,294,193,474,245,229,9.5,5.7,3.7,9.2,4.8,4.4
09377112,"Bärnau, St",09,Bayern,3227,1672,1555,323,235,88,245,181,64,10.0,7.3,2.7,7.6,5.6,2.0
09377116,"Erbendorf, St",09,Bayern,5150,2538,2612,449,298,151,430,299,131,8.7,5.8,2.9,8.3,5.8,2.5
09377118,Friedenfels,09,Bayern,1263,642,621,134,100,34,87,62,25,10.6,7.9,2.7,6.9,4.9,2.0
09377119,"Fuchsmühl, M",09,Bayern,1620,790,830,151,119,32,73,55,18,9.3,7.3,2.0,4.5,3.4,1.1
09377127,Immenreuth,09,Bayern,1885,971,914,193,130,63,156,100,56,10.2,6.9,3.3,8.3,5.3,3.0
09377131,"Konnersreuth, M",09,Bayern,1805,941,864,167,111,56,110,75,35,9.3,6.1,3.1,6.1,4.2,1.9
09377133,Kulmain,09,Bayern,2272,1103,1169,190,143,47,110,76,34,8.4,6.3,2.1,4.8,3.3,1.5
09377139,"Mähring, M",09,Bayern,1830,952,878,152,103,49,80,44,36,8.3,5.6,2.7,4.4,2.4,2.0
09377142,"Neualbenreuth, M",09,Bayern,1372,694,678,120,86,34,146,97,49,8.7,6.3,2.5,10.6,7.1,3.6
09377146,"Plößberg, M",09,Bayern,3294,1648,1646,321,220,101,251,141,110,9.7,6.7,3.1,7.6,4.3,3.3
09377154,"Tirschenreuth, St",09,Bayern,8899,4307,4592,834,554,280,859,603,256,9.4,6.2,3.1,9.7,6.8,2.9
09377157,"Waldershof, St",09,Bayern,4284,2120,2164,366,242,124,244,157,87,8.5,5.6,2.9,5.7,3.7,2.0
09377158,"Waldsassen, St",09,Bayern,6741,3329,3412,633,433,200,586,414,172,9.4,6.4,3.0,8.7,6.1,2.6
09377137,Leonberg,09,Bayern,1015,540,475,104,76,28,23,14,9,10.2,7.5,2.8,2.3,1.4,0.9
09377141,"Mitterteich, St",09,Bayern,6634,3261,3373,708,490,218,639,448,191,10.7,7.4,3.3,9.6,6.8,2.9
09377145,Pechbrunn,09,Bayern,1351,663,688,96,62,34,47,36,11,7.1,4.6,2.5,3.5,2.7,0.8
09377128,Kastl,09,Bayern,1393,718,675,133,86,47,54,29,25,9.5,6.2,3.4,3.9,2.1,1.8
09377129,"Kemnath, St",09,Bayern,5399,2633,2766,466,285,181,483,318,165,8.6,5.3,3.4,8.9,5.9,3.1
09377113,Brand,09,Bayern,1180,573,607,106,82,24,53,44,9,9.0,6.9,2.0,4.5,3.7,0.8
09377115,Ebnath,09,Bayern,1293,644,649,110,82,28,86,54,32,8.5,6.3,2.2,6.7,4.2,2.5
09377143,Neusorg,09,Bayern,1931,940,991,162,118,44,140,101,39,8.4,6.1,2.3,7.3,5.2,2.0
09377148,Pullenreuth,09,Bayern,1754,908,846,123,93,30,66,42,24,7.0,5.3,1.7,3.8,2.4,1.4
09377132,Krummennaab,09,Bayern,1473,751,722,136,98,38,57,45,12,9.2,6.7,2.6,3.9,3.1,0.8
09377149,Reuth b.Erbendorf,09,Bayern,1194,617,577,94,66,28,51,31,20,7.9,5.5,2.3,4.3,2.6,1.7
09377117,"Falkenberg, M",09,Bayern,940,472,468,96,62,34,68,39,29,10.2,6.6,3.6,7.2,4.1,3.1
09377159,"Wiesau, M",09,Bayern,4115,1999,2116,355,263,92,360,252,108,8.6,6.4,2.2,8.7,6.1,2.6
09461000,Bamberg,09,Bayern,73331,34767,38564,7639,5328,2311,14335,10409,3926,10.4,7.3,3.2,19.5,14.2,5.4
09462000,Bayreuth,09,Bayern,72148,34850,37298,7558,5168,2390,10506,7009,3497,10.5,7.2,3.3,14.6,9.7,4.8
09463000,Coburg,09,Bayern,41257,20004,21253,3431,2189,1242,4592,2898,1694,8.3,5.3,3.0,11.1,7.0,4.1
09464000,Hof,09,Bayern,44660,21342,23318,3723,2475,1248,5740,3774,1966,8.3,5.5,2.8,12.9,8.5,4.4
09471111,Altendorf,09,Bayern,2026,997,1029,213,135,78,92,55,37,10.5,6.7,3.8,4.5,2.7,1.8
09471117,Bischberg,09,Bayern,5996,2959,3037,581,370,211,348,202,146,9.7,6.2,3.5,5.8,3.4,2.4
09471119,Breitengüßbach,09,Bayern,4513,2177,2336,409,264,145,381,236,145,9.1,5.8,3.2,8.4,5.2,3.2
09471123,"Buttenheim, M",09,Bayern,3549,1784,1765,337,200,137,385,204,181,9.5,5.6,3.9,10.8,5.7,5.1
09471131,Frensdorf,09,Bayern,4961,2474,2487,467,283,184,272,166,106,9.4,5.7,3.7,5.5,3.3,2.1
09471137,Gundelsheim,09,Bayern,3367,1636,1731,337,214,123,161,94,67,10.0,6.4,3.7,4.8,2.8,2.0
09471140,"Hallstadt, St",09,Bayern,8330,4104,4226,843,513,330,1000,659,341,10.1,6.2,4.0,12.0,7.9,4.1
09471142,"Heiligenstadt i.OFr., M",09,Bayern,3538,1786,1752,499,358,141,236,151,85,14.1,10.1,4.0,6.7,4.3,2.4
09471145,"Hirschaid, M",09,Bayern,12097,6028,6069,1218,734,484,1262,834,428,10.1,6.1,4.0,10.4,6.9,3.5
09471150,Kemmern,09,Bayern,2595,1296,1299,258,163,95,226,120,106,9.9,6.3,3.7,8.7,4.6,4.1
09471155,Litzendorf,09,Bayern,6055,3023,3032,560,345,215,671,466,205,9.2,5.7,3.6,11.1,7.7,3.4
09471159,Memmelsdorf,09,Bayern,8831,4365,4466,895,579,316,477,310,167,10.1,6.6,3.6,5.4,3.5,1.9
09471165,Oberhaid,09,Bayern,4582,2253,2329,387,256,131,225,141,84,8.4,5.6,2.9,4.9,3.1,1.8
09471169,Pettstadt,09,Bayern,1968,987,981,202,141,61,128,73,55,10.3,7.2,3.1,6.5,3.7,2.8
09471172,Pommersfelden,09,Bayern,2933,1457,1476,297,178,119,323,194,129,10.1,6.1,4.1,11.0,6.6,4.4
09471174,"Rattelsdorf, M",09,Bayern,4592,2333,2259,457,285,172,350,225,125,10.0,6.2,3.7,7.6,4.9,2.7
09471185,"Scheßlitz, St",09,Bayern,7176,3697,3479,777,456,321,859,508,351,10.8,6.4,4.5,12.0,7.1,4.9
09471191,Stegaurach,09,Bayern,6978,3499,3479,644,426,218,406,267,139,9.2,6.1,3.1,5.8,3.8,2.0
09471195,Strullendorf,09,Bayern,7956,3958,3998,781,490,291,498,317,181,9.8,6.2,3.7,6.3,4.0,2.3
09471207,Viereth-Trunstadt,09,Bayern,3696,1851,1845,356,214,142,370,267,103,9.6,5.8,3.8,10.0,7.2,2.8
09471208,Walsdorf,09,Bayern,2616,1297,1319,257,171,86,164,115,49,9.8,6.5,3.3,6.3,4.4,1.9
09471214,"Zapfendorf, M",09,Bayern,5095,2568,2527,529,332,197,376,213,163,10.4,6.5,3.9,7.4,4.2,3.2
09471220,"Schlüsselfeld, St",09,Bayern,5872,3009,2863,534,336,198,471,267,204,9.1,5.7,3.4,8.0,4.5,3.5
09471115,"Baunach, St",09,Bayern,4005,2056,1949,375,239,136,304,200,104,9.4,6.0,3.4,7.6,5.0,2.6
09471133,Gerach,09,Bayern,925,457,468,85,54,31,-1,-1,-1,9.2,5.8,3.4,-0.1,,
09471152,Lauter,09,Bayern,1151,574,577,138,94,44,51,34,17,12.0,8.2,3.8,4.4,3.0,1.5
09471175,Reckendorf,09,Bayern,2047,1028,1019,212,151,61,149,110,39,10.4,7.4,3.0,7.3,5.4,1.9
09471151,Königsfeld,09,Bayern,1309,679,630,145,89,56,94,52,42,11.1,6.8,4.3,7.2,4.0,3.2
09471189,Stadelhofen,09,Bayern,1227,628,599,126,68,58,73,31,42,10.3,5.5,4.7,5.9,2.5,3.4
09471209,Wattendorf,09,Bayern,662,344,318,88,48,40,-1,-1,-1,13.3,7.3,6.0,-0.2,,
09471122,"Burgwindheim, M",09,Bayern,1273,652,621,123,76,47,93,44,49,9.7,6.0,3.7,7.3,3.5,3.8
09471128,"Ebrach, M",09,Bayern,1806,982,824,173,123,50,135,91,44,9.6,6.8,2.8,7.5,5.0,2.4
09471120,"Burgebrach, M",09,Bayern,6673,3392,3281,682,401,281,590,364,226,10.2,6.0,4.2,8.8,5.5,3.4
09471186,Schönbrunn i.Steigerwald,09,Bayern,1862,939,923,206,137,69,95,60,35,11.1,7.4,3.7,5.1,3.2,1.9
09471154,Lisberg,09,Bayern,1803,882,921,180,124,56,169,115,54,10.0,6.9,3.1,9.4,6.4,3.0
09471173,Priesendorf,09,Bayern,1505,755,750,166,102,64,83,58,25,11.0,6.8,4.3,5.5,3.9,1.7
09472111,Ahorntal,09,Bayern,2175,1122,1053,216,157,59,153,107,46,9.9,7.2,2.7,7.0,4.9,2.1
09472116,"Bad Berneck i.Fichtelgebirge, St",09,Bayern,4257,2089,2168,410,248,162,264,180,84,9.6,5.8,3.8,6.2,4.2,2.0
09472119,Bindlach,09,Bayern,7237,3493,3744,703,398,305,639,352,287,9.7,5.5,4.2,8.8,4.9,4.0
09472121,Bischofsgrün,09,Bayern,1885,961,924,175,125,50,125,93,32,9.3,6.6,2.7,6.6,4.9,1.7
09472131,Eckersdorf,09,Bayern,5102,2453,2649,430,288,142,200,133,67,8.4,5.6,2.8,3.9,2.6,1.3
09472138,Fichtelberg,09,Bayern,1872,919,953,183,117,66,146,96,50,9.8,6.2,3.5,7.8,5.1,2.7
09472139,"Gefrees, St",09,Bayern,4443,2148,2295,322,200,122,316,190,126,7.2,4.5,2.7,7.1,4.3,2.8
09472143,"Goldkronach, St",09,Bayern,3536,1733,1803,313,193,120,138,93,45,8.9,5.5,3.4,3.9,2.6,1.3
09472150,Heinersreuth,09,Bayern,3683,1813,1870,310,205,105,344,198,146,8.4,5.6,2.9,9.3,5.4,4.0
09472164,Mehlmeisel,09,Bayern,1321,669,652,130,92,38,62,39,23,9.8,7.0,2.9,4.7,3.0,1.7
09472175,"Pegnitz, St",09,Bayern,13356,6537,6819,1253,791,462,1024,652,372,9.4,5.9,3.5,7.7,4.9,2.8
09472179,"Pottenstein, St",09,Bayern,5306,2662,2644,490,302,188,321,203,118,9.2,5.7,3.5,6.0,3.8,2.2
09472190,Speichersdorf,09,Bayern,5809,2912,2897,491,306,185,245,162,83,8.5,5.3,3.2,4.2,2.8,1.4
09472197,"Waischenfeld, St",09,Bayern,3071,1588,1483,320,220,100,249,156,93,10.4,7.2,3.3,8.1,5.1,3.0
09472198,Warmensteinach,09,Bayern,2279,1139,1140,210,141,69,129,84,45,9.2,6.2,3.0,5.7,3.7,2.0
09472115,Aufseß,09,Bayern,1306,659,647,135,93,42,152,93,59,10.3,7.1,3.2,11.6,7.1,4.5
09472154,"Hollfeld, St",09,Bayern,5107,2502,2605,516,323,193,357,231,126,10.1,6.3,3.8,7.0,4.5,2.5
09472176,Plankenfels,09,Bayern,898,443,455,78,55,23,29,20,9,8.7,6.1,2.6,3.2,2.2,1.0
09472141,Glashütten,09,Bayern,1412,684,728,132,82,50,61,41,20,9.3,5.8,3.5,4.3,2.9,1.4
09472167,Mistelgau,09,Bayern,3775,1867,1908,357,215,142,215,139,76,9.5,5.7,3.8,5.7,3.7,2.0
09472140,Gesees,09,Bayern,1290,649,641,114,73,41,59,44,15,8.8,5.7,3.2,4.6,3.4,1.2
09472155,Hummeltal,09,Bayern,2374,1135,1239,218,126,92,105,64,41,9.2,5.3,3.9,4.4,2.7,1.7
09472166,Mistelbach,09,Bayern,1594,776,818,147,86,61,113,73,40,9.2,5.4,3.8,7.1,4.6,2.5
09472133,Emtmannsberg,09,Bayern,1054,516,538,98,63,35,68,47,21,9.3,6.0,3.3,6.5,4.5,2.0
09472156,Kirchenpingarten,09,Bayern,1244,651,593,117,87,30,45,32,13,9.4,7.0,2.4,3.6,2.6,1.0
09472188,Seybothenreuth,09,Bayern,1279,657,622,97,54,43,38,23,15,7.6,4.2,3.4,3.0,1.8,1.2
09472199,"Weidenberg, M",09,Bayern,5995,2951,3044,548,332,216,410,259,151,9.1,5.5,3.6,6.8,4.3,2.5
09472127,"Creußen, St",09,Bayern,4883,2400,2483,353,228,125,349,220,129,7.2,4.7,2.6,7.1,4.5,2.6
09472146,Haag,09,Bayern,952,467,485,76,43,33,30,20,10,8.0,4.5,3.5,3.2,2.1,1.1
09472180,Prebitz,09,Bayern,1020,521,499,86,60,26,21,9,12,8.4,5.9,2.5,2.1,0.9,1.2
09472184,"Schnabelwaid, M",09,Bayern,981,490,491,86,62,24,46,21,25,8.8,6.3,2.4,4.7,2.1,2.5
09472118,"Betzenstein, St",09,Bayern,2507,1262,1245,256,173,83,230,140,90,10.2,6.9,3.3,9.2,5.6,3.6
09472177,"Plech, M",09,Bayern,1303,648,655,130,81,49,112,57,55,10.0,6.2,3.8,8.6,4.4,4.2
09473112,Ahorn,09,Bayern,4184,2035,2149,337,191,146,217,136,81,8.1,4.6,3.5,5.2,3.3,1.9
09473120,Dörfles-Esbach,09,Bayern,3617,1738,1879,322,199,123,262,155,107,8.9,5.5,3.4,7.2,4.3,3.0
09473121,Ebersdorf b.Coburg,09,Bayern,5920,2931,2989,502,335,167,482,327,155,8.5,5.7,2.8,8.1,5.5,2.6
09473132,Großheirath,09,Bayern,2569,1302,1267,200,115,85,138,82,56,7.8,4.5,3.3,5.4,3.2,2.2
09473138,Itzgrund,09,Bayern,2286,1140,1146,195,125,70,174,100,74,8.5,5.5,3.1,7.6,4.4,3.2
09473141,Lautertal,09,Bayern,4269,2104,2165,338,206,132,217,124,93,7.9,4.8,3.1,5.1,2.9,2.2
09473144,Meeder,09,Bayern,3695,1830,1865,291,187,104,166,109,57,7.9,5.1,2.8,4.5,2.9,1.5
09473151,"Neustadt b.Coburg, GKSt",09,Bayern,15227,7439,7788,1144,702,442,893,547,346,7.5,4.6,2.9,5.9,3.6,2.3
09473158,"Bad Rodach, St",09,Bayern,6399,3126,3273,419,247,172,355,189,166,6.5,3.9,2.7,5.5,3.0,2.6
09473159,"Rödental, St",09,Bayern,13068,6448,6620,1016,635,381,775,480,295,7.8,4.9,2.9,5.9,3.7,2.3
09473165,"Seßlach, St",09,Bayern,3962,2025,1937,322,194,128,275,173,102,8.1,4.9,3.2,6.9,4.4,2.6
09473166,Sonnefeld,09,Bayern,4815,2386,2429,412,247,165,435,254,181,8.6,5.1,3.4,9.0,5.3,3.8
09473170,Untersiemau,09,Bayern,4112,2070,2042,339,209,130,340,213,127,8.2,5.1,3.2,8.3,5.2,3.1
09473174,Weidhausen b.Coburg,09,Bayern,3163,1599,1564,279,151,128,242,128,114,8.8,4.8,4.0,7.7,4.0,3.6
09473175,Weitramsdorf,09,Bayern,4918,2415,2503,412,257,155,161,97,64,8.4,5.2,3.2,3.3,2.0,1.3
09473134,Grub a.Forst,09,Bayern,2837,1436,1401,251,153,98,196,117,79,8.8,5.4,3.5,6.9,4.1,2.8
09473153,Niederfüllbach,09,Bayern,1558,757,801,128,74,54,128,83,45,8.2,4.7,3.5,8.2,5.3,2.9
09474123,"Eggolsheim, M",09,Bayern,6487,3252,3235,618,386,232,385,248,137,9.5,6.0,3.6,5.9,3.8,2.1
09474124,"Egloffstein, M",09,Bayern,2054,1060,994,203,111,92,178,114,64,9.9,5.4,4.5,8.7,5.6,3.1
09474126,"Forchheim, GKSt",09,Bayern,31651,15195,16456,2782,1667,1115,3800,2519,1281,8.8,5.3,3.5,12.0,8.0,4.0
09474129,"Gößweinstein, M",09,Bayern,4064,2074,1990,425,253,172,229,150,79,10.5,6.2,4.2,5.6,3.7,1.9
09474133,Hallerndorf,09,Bayern,4077,2069,2008,429,247,182,439,216,223,10.5,6.1,4.5,10.8,5.3,5.5
09474134,Hausen,09,Bayern,3667,1852,1815,294,180,114,290,179,111,8.0,4.9,3.1,7.9,4.9,3.0
09474135,Heroldsbach,09,Bayern,5107,2539,2568,469,283,186,247,163,84,9.2,5.5,3.6,4.8,3.2,1.6
09474140,"Igensdorf, M",09,Bayern,5025,2567,2458,418,230,188,256,155,101,8.3,4.6,3.7,5.1,3.1,2.0
09474146,Langensendelbach,09,Bayern,3046,1476,1570,226,140,86,113,69,44,7.4,4.6,2.8,3.7,2.3,1.4
09474154,"Neunkirchen a.Brand, M",09,Bayern,7968,3920,4048,632,411,221,564,367,197,7.9,5.2,2.8,7.1,4.6,2.5
09474156,Obertrubach,09,Bayern,2204,1143,1061,247,149,98,268,139,129,11.2,6.8,4.4,12.2,6.3,5.9
09474161,"Pretzfeld, M",09,Bayern,2426,1190,1236,246,157,89,212,118,94,10.1,6.5,3.7,8.7,4.9,3.9
09474176,"Wiesenttal, M",09,Bayern,2464,1225,1239,191,127,64,200,128,72,7.8,5.2,2.6,8.1,5.2,2.9
09474121,"Ebermannstadt, St",09,Bayern,6904,3435,3469,706,442,264,683,411,272,10.2,6.4,3.8,9.9,6.0,3.9
09474168,Unterleinleiter,09,Bayern,1243,602,641,91,52,39,64,44,20,7.3,4.2,3.1,5.1,3.5,1.6
09474145,Kunreuth,09,Bayern,1394,690,704,129,71,58,57,30,27,9.3,5.1,4.2,4.1,2.2,1.9
09474158,Pinzberg,09,Bayern,1903,946,957,187,101,86,112,59,53,9.8,5.3,4.5,5.9,3.1,2.8
09474175,Wiesenthau,09,Bayern,1630,827,803,162,93,69,130,61,69,9.9,5.7,4.2,8.0,3.7,4.2
09474143,Kirchehrenbach,09,Bayern,2266,1158,1108,207,132,75,133,83,50,9.1,5.8,3.3,5.9,3.7,2.2
09474147,Leutenbach,09,Bayern,1632,847,785,153,89,64,73,40,33,9.4,5.5,3.9,4.5,2.5,2.0
09474171,Weilersbach,09,Bayern,2031,1004,1027,199,112,87,71,31,40,9.8,5.5,4.3,3.5,1.5,2.0
09474122,Effeltrich,09,Bayern,2560,1264,1296,199,127,72,140,77,63,7.8,5.0,2.8,5.5,3.0,2.5
09474160,Poxdorf,09,Bayern,1498,753,745,98,60,38,61,40,21,6.5,4.0,2.5,4.1,2.7,1.4
09474119,Dormitz,09,Bayern,2087,1036,1051,159,99,60,63,45,18,7.6,4.7,2.9,3.0,2.2,0.9
09474137,Hetzles,09,Bayern,1274,634,640,106,64,42,97,52,45,8.3,5.0,3.3,7.6,4.1,3.5
09474144,Kleinsendelbach,09,Bayern,1479,733,746,116,69,47,39,24,15,7.8,4.7,3.2,2.6,1.6,1.0
09474132,"Gräfenberg, St",09,Bayern,4071,2045,2026,378,248,130,348,220,128,9.3,6.1,3.2,8.5,5.4,3.1
09474138,"Hiltpoltstein, M",09,Bayern,1527,792,735,142,82,60,68,34,34,9.3,5.4,3.9,4.5,2.2,2.2
09474173,Weißenohe,09,Bayern,1095,537,558,114,70,44,66,44,22,10.4,6.4,4.0,6.0,4.0,2.0
09475112,"Bad Steben, M",09,Bayern,3435,1631,1804,242,145,97,308,187,121,7.0,4.2,2.8,9.0,5.4,3.5
09475113,Berg,09,Bayern,2138,1059,1079,202,123,79,195,116,79,9.4,5.8,3.7,9.1,5.4,3.7
09475120,Döhlau,09,Bayern,3920,1943,1977,339,213,126,132,79,53,8.6,5.4,3.2,3.4,2.0,1.4
09475128,Geroldsgrün,09,Bayern,2916,1460,1456,200,132,68,90,54,36,6.9,4.5,2.3,3.1,1.9,1.2
09475136,"Helmbrechts, St",09,Bayern,8497,4146,4351,645,407,238,526,350,176,7.6,4.8,2.8,6.2,4.1,2.1
09475141,Köditz,09,Bayern,2505,1228,1277,207,125,82,102,65,37,8.3,5.0,3.3,4.1,2.6,1.5
09475142,Konradsreuth,09,Bayern,3230,1582,1648,242,153,89,169,104,65,7.5,4.7,2.8,5.2,3.2,2.0
09475154,"Münchberg, St",09,Bayern,10320,4979,5341,768,505,263,807,508,299,7.4,4.9,2.5,7.8,4.9,2.9
09475156,"Naila, St",09,Bayern,7640,3656,3984,625,391,234,507,327,180,8.2,5.1,3.1,6.6,4.3,2.4
09475158,"Oberkotzau, M",09,Bayern,5366,2608,2758,413,276,137,235,168,67,7.7,5.1,2.6,4.4,3.1,1.2
09475161,Regnitzlosau,09,Bayern,2319,1142,1177,189,124,65,144,94,50,8.2,5.3,2.8,6.2,4.1,2.2
09475162,"Rehau, St",09,Bayern,9335,4545,4790,660,411,249,585,378,207,7.1,4.4,2.7,6.3,4.0,2.2
09475168,"Schwarzenbach a.d.Saale, St",09,Bayern,7141,3529,3612,560,349,211,340,215,125,7.8,4.9,3.0,4.8,3.0,1.8
09475169,"Schwarzenbach a.Wald, St",09,Bayern,4587,2241,2346,336,205,131,208,129,79,7.3,4.5,2.9,4.5,2.8,1.7
09475171,"Selbitz, St",09,Bayern,4359,2062,2297,283,177,106,290,179,111,6.5,4.1,2.4,6.7,4.1,2.5
09475175,"Stammbach, M",09,Bayern,2368,1156,1212,171,105,66,87,49,38,7.2,4.4,2.8,3.7,2.1,1.6
09475189,"Zell im Fichtelgebirge, M",09,Bayern,2005,993,1012,176,105,71,96,52,44,8.8,5.2,3.5,4.8,2.6,2.2
09475137,Issigau,09,Bayern,991,490,501,75,45,30,56,37,19,7.6,4.5,3.0,5.7,3.7,1.9
09475146,"Lichtenberg, St",09,Bayern,1012,484,528,76,53,23,45,31,14,7.5,5.2,2.3,4.4,3.1,1.4
09475123,Feilitzsch,09,Bayern,2862,1456,1406,194,127,67,146,83,63,6.8,4.4,2.3,5.1,2.9,2.2
09475127,Gattendorf,09,Bayern,1021,502,519,90,63,27,36,28,8,8.8,6.2,2.6,3.5,2.7,0.8
09475181,Töpen,09,Bayern,1056,520,536,83,58,25,548,479,69,7.9,5.5,2.4,51.9,45.4,6.5
09475182,Trogen,09,Bayern,1435,689,746,118,81,37,45,32,13,8.2,5.6,2.6,3.1,2.2,0.9
09475145,Leupoldsgrün,09,Bayern,1189,575,614,94,68,26,138,95,43,7.9,5.7,2.2,11.6,8.0,3.6
09475165,"Schauenstein, St",09,Bayern,1977,967,1010,136,86,50,91,64,27,6.9,4.4,2.5,4.6,3.2,1.4
09475174,"Sparneck, M",09,Bayern,1639,801,838,153,95,58,85,55,30,9.3,5.8,3.5,5.2,3.4,1.8
09475184,Weißdorf,09,Bayern,1166,564,602,80,50,30,66,43,23,6.9,4.3,2.6,5.7,3.7,2.0
09476145,"Kronach, St",09,Bayern,16808,8164,8644,1421,876,545,2034,1247,787,8.5,5.2,3.2,12.1,7.4,4.7
09476146,"Küps, M",09,Bayern,7700,3758,3942,728,441,287,463,288,175,9.5,5.7,3.7,6.0,3.7,2.3
09476152,"Ludwigsstadt, St",09,Bayern,3430,1696,1734,243,154,89,285,188,97,7.1,4.5,2.6,8.3,5.5,2.8
09476159,"Nordhalben, M",09,Bayern,1729,854,875,132,90,42,82,56,26,7.6,5.2,2.4,4.7,3.2,1.5
09476164,"Pressig, M",09,Bayern,3981,1959,2022,331,194,137,214,125,89,8.3,4.9,3.4,5.4,3.1,2.2
09476175,Steinbach a.Wald,09,Bayern,3180,1576,1604,265,179,86,159,94,65,8.3,5.6,2.7,5.0,3.0,2.0
09476177,"Steinwiesen, M",09,Bayern,3510,1769,1741,277,204,73,176,136,40,7.9,5.8,2.1,5.0,3.9,1.1
09476178,Stockheim,09,Bayern,5035,2507,2528,435,264,171,296,186,110,8.6,5.2,3.4,5.9,3.7,2.2
09476179,"Tettau, M",09,Bayern,2117,1047,1070,201,130,71,322,222,100,9.5,6.1,3.4,15.2,10.5,4.7
09476183,"Marktrodach, M",09,Bayern,3720,1813,1907,356,231,125,246,161,85,9.6,6.2,3.4,6.6,4.3,2.3
09476184,"Wallenfels, St",09,Bayern,2783,1392,1391,227,154,73,141,96,45,8.2,5.5,2.6,5.1,3.4,1.6
09476185,Weißenbrunn,09,Bayern,2919,1463,1456,268,167,101,212,148,64,9.2,5.7,3.5,7.3,5.1,2.2
09476189,Wilhelmsthal,09,Bayern,3741,1859,1882,324,206,118,180,105,75,8.7,5.5,3.2,4.8,2.8,2.0
09476166,Reichenbach,09,Bayern,716,362,354,64,38,26,-1,-1,-1,8.9,5.3,3.6,-0.1,,
09476180,"Teuschnitz, St",09,Bayern,2020,987,1033,153,88,65,72,49,23,7.6,4.4,3.2,3.6,2.4,1.1
09476182,Tschirn,09,Bayern,553,272,281,28,17,11,-1,-1,-1,5.1,3.1,2.0,-0.2,,
09476154,"Mitwitz, M",09,Bayern,2898,1475,1423,241,146,95,252,149,103,8.3,5.0,3.3,8.7,5.1,3.6
09476171,Schneckenlohe,09,Bayern,1076,522,554,92,47,45,85,38,47,8.6,4.4,4.2,7.9,3.5,4.4
09477121,Himmelkron,09,Bayern,3480,1691,1789,249,143,106,303,178,125,7.2,4.1,3.0,8.7,5.1,3.6
09477128,"Kulmbach, GKSt",09,Bayern,25933,12497,13436,2324,1455,869,3325,2111,1214,9.0,5.6,3.4,12.8,8.1,4.7
09477136,"Mainleus, M",09,Bayern,6495,3241,3254,604,353,251,312,202,110,9.3,5.4,3.9,4.8,3.1,1.7
09477139,"Marktschorgast, M",09,Bayern,1418,692,726,109,70,39,44,35,9,7.7,4.9,2.8,3.1,2.5,0.6
09477142,Neudrossenfeld,09,Bayern,3798,1864,1934,369,226,143,217,140,77,9.7,6.0,3.8,5.7,3.7,2.0
09477143,Neuenmarkt,09,Bayern,3016,1512,1504,251,168,83,185,107,78,8.3,5.6,2.8,6.1,3.5,2.6
09477148,"Presseck, M",09,Bayern,1869,909,960,170,114,56,102,65,37,9.1,6.1,3.0,5.5,3.5,2.0
09477157,"Thurnau, M",09,Bayern,4183,2056,2127,384,253,131,226,154,72,9.2,6.0,3.1,5.4,3.7,1.7
09477163,"Wirsberg, M",09,Bayern,1842,885,957,174,110,64,101,72,29,9.4,6.0,3.5,5.5,3.9,1.6
09477151,Rugendorf,09,Bayern,1026,511,515,88,57,31,75,49,26,8.6,5.6,3.0,7.3,4.8,2.5
09477156,"Stadtsteinach, St",09,Bayern,3229,1569,1660,285,187,98,203,137,66,8.8,5.8,3.0,6.3,4.2,2.0
09477117,"Grafengehaig, M",09,Bayern,887,435,452,84,61,23,27,16,11,9.5,6.9,2.6,3.0,1.8,1.2
09477138,"Marktleugast, M",09,Bayern,3184,1599,1585,220,127,93,148,81,67,6.9,4.0,2.9,4.6,2.5,2.1
09477118,Guttenberg,09,Bayern,501,243,258,32,21,11,20,15,5,6.4,4.2,2.2,4.0,3.0,1.0
09477129,"Kupferberg, St",09,Bayern,1030,521,509,91,59,32,41,30,11,8.8,5.7,3.1,4.0,2.9,1.1
09477135,"Ludwigschorgast, M",09,Bayern,985,486,499,95,53,42,36,18,18,9.6,5.4,4.3,3.7,1.8,1.8
09477159,Untersteinach,09,Bayern,1837,939,898,184,127,57,181,103,78,10.0,6.9,3.1,9.9,5.6,4.2
09477124,"Kasendorf, M",09,Bayern,2467,1228,1239,234,148,86,171,120,51,9.5,6.0,3.5,6.9,4.9,2.1
09477164,"Wonsees, M",09,Bayern,1125,562,563,104,83,21,71,49,22,9.2,7.4,1.9,6.3,4.4,2.0
09477119,Harsdorf,09,Bayern,980,485,495,93,57,36,36,24,12,9.5,5.8,3.7,3.7,2.4,1.2
09477127,Ködnitz,09,Bayern,1595,769,826,130,76,54,50,29,21,8.2,4.8,3.4,3.1,1.8,1.3
09477158,Trebgast,09,Bayern,1588,809,779,149,89,60,86,49,37,9.4,5.6,3.8,5.4,3.1,2.3
09478111,Altenkunstadt,09,Bayern,5380,2610,2770,430,267,163,650,419,231,8.0,5.0,3.0,12.1,7.8,4.3
09478116,"Burgkunstadt, St",09,Bayern,6384,3067,3317,517,323,194,495,308,187,8.1,5.1,3.0,7.8,4.8,2.9
09478120,"Ebensfeld, M",09,Bayern,5576,2805,2771,534,345,189,380,230,150,9.6,6.2,3.4,6.8,4.1,2.7
09478139,"Lichtenfels, St",09,Bayern,20169,9942,10227,1995,1253,742,1913,1230,683,9.9,6.2,3.7,9.5,6.1,3.4
09478145,Michelau i.OFr.,09,Bayern,6336,3119,3217,564,322,242,406,247,159,8.9,5.1,3.8,6.4,3.9,2.5
09478165,"Bad Staffelstein, St",09,Bayern,10231,5012,5219,1064,695,369,1176,747,429,10.4,6.8,3.6,11.5,7.3,4.2
09478176,"Weismain, St",09,Bayern,4821,2434,2387,431,277,154,358,199,159,8.9,5.7,3.2,7.4,4.1,3.3
09478143,"Marktgraitz, M",09,Bayern,1184,572,612,108,69,39,75,47,28,9.1,5.8,3.3,6.3,4.0,2.4
09478155,Redwitz a.d.Rodach,09,Bayern,3364,1682,1682,245,149,96,200,118,82,7.3,4.4,2.9,5.9,3.5,2.4
09478127,Hochstadt a.Main,09,Bayern,1671,814,857,156,98,58,65,40,25,9.3,5.9,3.5,3.9,2.4,1.5
09478144,"Marktzeuln, M",09,Bayern,1539,760,779,130,79,51,89,50,39,8.4,5.1,3.3,5.8,3.2,2.5
09479112,"Arzberg, St",09,Bayern,5196,2559,2637,360,248,112,290,210,80,6.9,4.8,2.2,5.6,4.0,1.5
09479129,"Kirchenlamitz, St",09,Bayern,3313,1629,1684,240,163,77,146,85,61,7.2,4.9,2.3,4.4,2.6,1.8
09479135,"Marktleuthen, St",09,Bayern,3144,1530,1614,249,169,80,161,116,45,7.9,5.4,2.5,5.1,3.7,1.4
09479136,"Marktredwitz, GKSt",09,Bayern,17130,8147,8983,1329,878,451,1542,1017,525,7.8,5.1,2.6,9.0,5.9,3.1
09479145,Röslau,09,Bayern,2158,1088,1070,129,86,43,76,49,27,6.0,4.0,2.0,3.5,2.3,1.3
09479150,"Schönwald, St",09,Bayern,3207,1533,1674,212,132,80,142,94,48,6.6,4.1,2.5,4.4,2.9,1.5
09479152,"Selb, GKSt",09,Bayern,14928,7159,7769,1152,771,381,1258,823,435,7.7,5.2,2.6,8.4,5.5,2.9
09479166,"Weißenstadt, St",09,Bayern,3120,1516,1604,241,151,90,204,141,63,7.7,4.8,2.9,6.5,4.5,2.0
09479169,"Wunsiedel, St",09,Bayern,9203,4505,4698,763,505,258,764,500,264,8.3,5.5,2.8,8.3,5.4,2.9
09479126,Höchstädt i.Fichtelgebirge,09,Bayern,1129,560,569,76,43,33,50,26,24,6.7,3.8,2.9,4.4,2.3,2.1
09479158,"Thiersheim, M",09,Bayern,1826,901,925,142,93,49,147,111,36,7.8,5.1,2.7,8.1,6.1,2.0
09479159,"Thierstein, M",09,Bayern,1157,560,597,77,47,30,47,30,17,6.7,4.1,2.6,4.1,2.6,1.5
09479127,"Hohenberg a.d.Eger, St",09,Bayern,1424,697,727,97,66,31,60,41,19,6.8,4.6,2.2,4.2,2.9,1.3
09479147,"Schirnding, M",09,Bayern,1192,588,604,91,63,28,41,28,13,7.6,5.3,2.3,3.4,2.3,1.1
09479111,Bad Alexandersbad,09,Bayern,976,474,502,73,54,19,73,50,23,7.5,5.5,1.9,7.5,5.1,2.4
09479138,Nagel,09,Bayern,1730,855,875,152,115,37,65,51,14,8.8,6.6,2.1,3.8,2.9,0.8
09479161,Tröstau,09,Bayern,2352,1169,1183,189,126,63,157,113,44,8.0,5.4,2.7,6.7,4.8,1.9
09561000,Ansbach,09,Bayern,41159,19778,21381,3624,2161,1463,5430,3369,2061,8.8,5.3,3.6,13.2,8.2,5.0
09562000,Erlangen,09,Bayern,108336,53454,54882,9810,6422,3388,12531,8552,3979,9.1,5.9,3.1,11.6,7.9,3.7
09563000,Fürth,09,Bayern,124171,60669,63502,10632,6093,4539,9658,5793,3865,8.6,4.9,3.7,7.8,4.7,3.1
09564000,Nürnberg,09,Bayern,509975,247931,262044,45360,27095,18265,57014,33614,23400,8.9,5.3,3.6,11.2,6.6,4.6
09565000,Schwabach,09,Bayern,40428,19710,20718,3555,2072,1483,3701,2134,1567,8.8,5.1,3.7,9.2,5.3,3.9
09571113,"Arberg, M",09,Bayern,2278,1141,1137,222,147,75,132,78,54,9.7,6.5,3.3,5.8,3.4,2.4
09571114,Aurach,09,Bayern,2902,1463,1439,260,159,101,257,155,102,9.0,5.5,3.5,8.9,5.3,3.5
09571115,"Bechhofen, M",09,Bayern,5937,3041,2896,610,364,246,566,347,219,10.3,6.1,4.1,9.5,5.8,3.7
09571127,Burgoberbach,09,Bayern,3275,1643,1632,276,160,116,139,89,50,8.4,4.9,3.5,4.2,2.7,1.5
09571130,"Colmberg, M",09,Bayern,1977,981,996,189,104,85,122,67,55,9.6,5.3,4.3,6.2,3.4,2.8
09571135,"Dietenhofen, M",09,Bayern,5572,2819,2753,515,301,214,406,248,158,9.2,5.4,3.8,7.3,4.5,2.8
09571136,"Dinkelsbühl, GKSt",09,Bayern,11538,5683,5855,1368,795,573,1826,1083,743,11.9,6.9,5.0,15.8,9.4,6.4
09571139,"Dürrwangen, M",09,Bayern,2585,1306,1279,292,186,106,149,86,63,11.3,7.2,4.1,5.8,3.3,2.4
09571145,"Feuchtwangen, St",09,Bayern,12238,6090,6148,1284,794,490,1189,737,452,10.5,6.5,4.0,9.7,6.0,3.7
09571146,"Flachslanden, M",09,Bayern,2348,1181,1167,235,145,90,154,86,68,10.0,6.2,3.8,6.6,3.7,2.9
09571165,"Heilsbronn, St",09,Bayern,9235,4536,4699,852,505,347,631,399,232,9.2,5.5,3.8,6.8,4.3,2.5
09571166,"Herrieden, St",09,Bayern,7830,3900,3930,669,393,276,481,302,179,8.5,5.0,3.5,6.1,3.9,2.3
09571170,Langfurth,09,Bayern,2102,1063,1039,191,119,72,131,78,53,9.1,5.7,3.4,6.2,3.7,2.5
09571171,"Lehrberg, M",09,Bayern,3105,1592,1513,283,175,108,154,92,62,9.1,5.6,3.5,5.0,3.0,2.0
09571174,"Leutershausen, St",09,Bayern,5556,2792,2764,560,362,198,359,222,137,10.1,6.5,3.6,6.5,4.0,2.5
09571175,"Lichtenau, M",09,Bayern,3806,1910,1896,356,202,154,276,162,114,9.4,5.3,4.0,7.3,4.3,3.0
09571177,"Merkendorf, St",09,Bayern,2861,1429,1432,327,211,116,227,140,87,11.4,7.4,4.1,7.9,4.9,3.0
09571180,Neuendettelsau,09,Bayern,7674,3606,4068,582,334,248,600,368,232,7.6,4.4,3.2,7.8,4.8,3.0
09571183,Oberdachstetten,09,Bayern,1585,786,799,140,96,44,93,60,33,8.8,6.1,2.8,5.9,3.8,2.1
09571190,Petersaurach,09,Bayern,4894,2466,2428,371,226,145,218,129,89,7.6,4.6,3.0,4.5,2.6,1.8
09571193,"Rothenburg ob der Tauber, GKSt",09,Bayern,11041,5354,5687,1065,645,420,1335,820,515,9.6,5.8,3.8,12.1,7.4,4.7
09571196,Sachsen b.Ansbach,09,Bayern,3410,1709,1701,301,189,112,186,96,90,8.8,5.5,3.3,5.5,2.8,2.6
09571199,Schnelldorf,09,Bayern,3527,1814,1713,388,249,139,352,198,154,11.0,7.1,3.9,10.0,5.6,4.4
09571200,"Schopfloch, M",09,Bayern,2948,1562,1386,285,178,107,161,112,49,9.7,6.0,3.6,5.5,3.8,1.7
09571214,"Wassertrüdingen, St",09,Bayern,5962,2974,2988,503,308,195,484,328,156,8.4,5.2,3.3,8.1,5.5,2.6
09571226,"Windsbach, St",09,Bayern,6094,3141,2953,580,332,248,430,253,177,9.5,5.4,4.1,7.1,4.2,2.9
09571111,Adelshofen,09,Bayern,979,506,473,129,87,42,78,43,35,13.2,8.9,4.3,8.0,4.4,3.6
09571152,Gebsattel,09,Bayern,1718,875,843,211,121,90,102,68,34,12.3,7.0,5.2,5.9,4.0,2.0
09571155,Geslau,09,Bayern,1322,674,648,173,108,65,150,84,66,13.1,8.2,4.9,11.3,6.4,5.0
09571169,Insingen,09,Bayern,1184,620,564,122,77,45,116,64,52,10.3,6.5,3.8,9.8,5.4,4.4
09571181,Neusitz,09,Bayern,2036,997,1039,224,135,89,109,60,49,11.0,6.6,4.4,5.4,2.9,2.4
09571188,Ohrenbach,09,Bayern,630,314,316,91,61,30,72,43,29,14.4,9.7,4.8,11.4,6.8,4.6
09571205,Steinsfeld,09,Bayern,1213,614,599,134,93,41,116,75,41,11.0,7.7,3.4,9.6,6.2,3.4
09571225,Windelsbach,09,Bayern,1091,572,519,121,77,44,115,77,38,11.1,7.1,4.0,10.5,7.1,3.5
09571125,Buch a.Wald,09,Bayern,1002,524,478,95,58,37,104,55,49,9.5,5.8,3.7,10.4,5.5,4.9
09571134,Diebach,09,Bayern,1116,583,533,127,77,50,48,30,18,11.4,6.9,4.5,4.3,2.7,1.6
09571137,"Dombühl, M",09,Bayern,1739,923,816,140,88,52,97,53,44,8.1,5.1,3.0,5.6,3.0,2.5
09571198,"Schillingsfürst, St",09,Bayern,2777,1368,1409,242,132,110,253,163,90,8.7,4.8,4.0,9.1,5.9,3.2
09571222,Wettringen,09,Bayern,994,523,471,97,54,43,63,39,24,9.8,5.4,4.3,6.3,3.9,2.4
09571228,Wörnitz,09,Bayern,1772,899,873,170,98,72,151,83,68,9.6,5.5,4.1,8.5,4.7,3.8
09571122,Bruckberg,09,Bayern,1389,763,626,88,58,30,79,53,26,6.3,4.2,2.2,5.7,3.8,1.9
09571194,Rügland,09,Bayern,1235,609,626,134,81,53,94,58,36,10.9,6.6,4.3,7.6,4.7,2.9
09571217,Weihenzell,09,Bayern,2865,1449,1416,277,152,125,225,140,85,9.7,5.3,4.4,7.9,4.9,3.0
09571189,"Ornbau, St",09,Bayern,1638,827,811,150,96,54,71,44,27,9.2,5.9,3.3,4.3,2.7,1.6
09571216,"Weidenbach, M",09,Bayern,2195,1136,1059,232,152,80,240,148,92,10.6,6.9,3.6,10.9,6.7,4.2
09571128,Burk,09,Bayern,1086,542,544,102,65,37,58,40,18,9.4,6.0,3.4,5.3,3.7,1.7
09571132,"Dentlein a.Forst, M",09,Bayern,2336,1171,1165,220,141,79,142,89,53,9.4,6.0,3.4,6.1,3.8,2.3
09571223,Wieseth,09,Bayern,1347,681,666,146,86,60,80,44,36,10.8,6.4,4.5,5.9,3.3,2.7
09571179,Mönchsroth,09,Bayern,1579,797,782,190,119,71,96,61,35,12.0,7.5,4.5,6.1,3.9,2.2
09571218,"Weiltingen, M",09,Bayern,1343,693,650,156,107,49,88,61,27,11.6,8.0,3.6,6.6,4.5,2.0
09571224,Wilburgstetten,09,Bayern,2076,1077,999,264,169,95,188,120,68,12.7,8.1,4.6,9.1,5.8,3.3
09571141,Ehingen,09,Bayern,1951,985,966,180,112,68,87,56,31,9.2,5.7,3.5,4.5,2.9,1.6
09571154,Gerolfingen,09,Bayern,951,481,470,106,66,40,89,51,38,11.1,6.9,4.2,9.4,5.4,4.0
09571192,Röckingen,09,Bayern,750,375,375,73,54,19,27,21,6,9.7,7.2,2.5,3.6,2.8,0.8
09571208,Unterschwaningen,09,Bayern,870,427,443,82,46,36,68,44,24,9.4,5.3,4.1,7.8,5.1,2.8
09571227,Wittelshofen,09,Bayern,1237,626,611,150,90,60,89,46,43,12.1,7.3,4.9,7.2,3.7,3.5
09571178,Mitteleschenbach,09,Bayern,1568,766,802,132,75,57,59,34,25,8.4,4.8,3.6,3.8,2.2,1.6
09571229,"Wolframs-Eschenbach, St",09,Bayern,3045,1554,1491,280,184,96,155,95,60,9.2,6.0,3.2,5.1,3.1,2.0
09572111,Adelsdorf,09,Bayern,7429,3754,3675,626,381,245,451,285,166,8.4,5.1,3.3,6.1,3.8,2.2
09572115,"Baiersdorf, St",09,Bayern,7489,3707,3782,581,347,234,523,332,191,7.8,4.6,3.1,7.0,4.4,2.6
09572119,Bubenreuth,09,Bayern,4591,2248,2343,343,218,125,264,164,100,7.5,4.7,2.7,5.8,3.6,2.2
09572121,"Eckental, M",09,Bayern,14229,7016,7213,1343,876,467,1046,686,360,9.4,6.2,3.3,7.4,4.8,2.5
09572130,Hemhofen,09,Bayern,5367,2636,2731,385,242,143,226,139,87,7.2,4.5,2.7,4.2,2.6,1.6
09572131,"Heroldsberg, M",09,Bayern,8487,4083,4404,714,458,256,750,496,254,8.4,5.4,3.0,8.8,5.8,3.0
09572132,"Herzogenaurach, St",09,Bayern,23095,11596,11499,1913,1128,785,1997,1240,757,8.3,4.9,3.4,8.6,5.4,3.3
09572135,"Höchstadt a.d.Aisch, St",09,Bayern,13251,6606,6645,1174,679,495,1095,659,436,8.9,5.1,3.7,8.3,5.0,3.3
09572137,Kalchreuth,09,Bayern,2908,1414,1494,245,134,111,238,137,101,8.4,4.6,3.8,8.2,4.7,3.5
09572142,Möhrendorf,09,Bayern,4854,2460,2394,347,241,106,211,130,81,7.1,5.0,2.2,4.3,2.7,1.7
09572149,Röttenbach,09,Bayern,4699,2275,2424,352,213,139,289,172,117,7.5,4.5,3.0,6.2,3.7,2.5
09572160,"Wachenroth, M",09,Bayern,2248,1165,1083,219,124,95,145,95,50,9.7,5.5,4.2,6.5,4.2,2.2
09572164,"Weisendorf, M",09,Bayern,6465,3174,3291,615,372,243,623,292,331,9.5,5.8,3.8,9.6,4.5,5.1
09572126,Gremsdorf,09,Bayern,1619,927,692,92,52,40,123,52,71,5.7,3.2,2.5,7.6,3.2,4.4
09572139,"Lonnerstadt, M",09,Bayern,1998,1002,996,174,98,76,115,67,48,8.7,4.9,3.8,5.8,3.4,2.4
09572143,"Mühlhausen, M",09,Bayern,1697,846,851,186,98,88,119,66,53,11.0,5.8,5.2,7.0,3.9,3.1
09572159,"Vestenbergsgreuth, M",09,Bayern,1498,763,735,139,78,61,81,46,35,9.3,5.2,4.1,5.4,3.1,2.3
09572114,Aurachtal,09,Bayern,3029,1554,1475,274,158,116,175,102,73,9.0,5.2,3.8,5.8,3.4,2.4
09572147,Oberreichenbach,09,Bayern,1271,642,629,95,59,36,30,14,16,7.5,4.6,2.8,2.4,1.1,1.3
09572120,Buckenhof,09,Bayern,3139,1531,1608,190,124,66,120,76,44,6.1,4.0,2.1,3.8,2.4,1.4
09572141,Marloffstein,09,Bayern,1561,783,778,94,58,36,107,57,50,6.0,3.7,2.3,6.9,3.7,3.2
09572154,Spardorf,09,Bayern,2129,1056,1073,125,84,41,56,36,20,5.9,3.9,1.9,2.6,1.7,0.9
09572158,Uttenreuth,09,Bayern,5083,2502,2581,340,231,109,252,175,77,6.7,4.5,2.1,5.0,3.4,1.5
09572127,Großenseebach,09,Bayern,2395,1155,1240,182,121,61,76,51,25,7.6,5.1,2.5,3.2,2.1,1.0
09572133,Heßdorf,09,Bayern,3605,1827,1778,308,197,111,144,97,47,8.5,5.5,3.1,4.0,2.7,1.3
09573111,"Ammerndorf, M",09,Bayern,2067,1049,1018,186,102,84,177,107,70,9.0,4.9,4.1,8.6,5.2,3.4
09573114,"Cadolzburg, M",09,Bayern,10741,5279,5462,993,592,401,784,471,313,9.2,5.5,3.7,7.3,4.4,2.9
09573115,Großhabersdorf,09,Bayern,4029,1981,2048,328,200,128,254,149,105,8.1,5.0,3.2,6.3,3.7,2.6
09573120,"Langenzenn, St",09,Bayern,10535,5074,5461,914,545,369,961,562,399,8.7,5.2,3.5,9.1,5.3,3.8
09573122,"Oberasbach, St",09,Bayern,17520,8373,9147,1409,808,601,895,558,337,8.0,4.6,3.4,5.1,3.2,1.9
09573124,Puschendorf,09,Bayern,2167,1024,1143,174,111,63,149,105,44,8.0,5.1,2.9,6.9,4.8,2.0
09573125,"Roßtal, M",09,Bayern,9612,4750,4862,793,505,288,499,311,188,8.3,5.3,3.0,5.2,3.2,2.0
09573127,"Stein, St",09,Bayern,13789,6543,7246,1086,657,429,802,443,359,7.9,4.8,3.1,5.8,3.2,2.6
09573133,"Wilhermsdorf, M",09,Bayern,5102,2580,2522,472,270,202,282,171,111,9.3,5.3,4.0,5.5,3.4,2.2
09573134,"Zirndorf, St",09,Bayern,24627,11781,12846,2138,1236,902,1654,1021,633,8.7,5.0,3.7,6.7,4.1,2.6
09573126,Seukendorf,09,Bayern,3143,1554,1589,282,165,117,146,74,72,9.0,5.2,3.7,4.6,2.4,2.3
09573130,Veitsbronn,09,Bayern,6386,3138,3248,554,337,217,362,235,127,8.7,5.3,3.4,5.7,3.7,2.0
09573123,Obermichelbach,09,Bayern,3230,1590,1640,225,153,72,191,126,65,7.0,4.7,2.2,5.9,3.9,2.0
09573129,Tuchenbach,09,Bayern,1343,665,678,94,50,44,58,32,26,7.0,3.7,3.3,4.3,2.4,1.9
09574112,"Altdorf b.Nürnberg, St",09,Bayern,15260,7497,7763,1379,800,579,1397,817,580,9.0,5.2,3.8,9.2,5.4,3.8
09574117,Burgthann,09,Bayern,11279,5652,5627,989,617,372,710,438,272,8.8,5.5,3.3,6.3,3.9,2.4
09574123,"Feucht, M",09,Bayern,13491,6599,6892,1171,673,498,882,514,368,8.7,5.0,3.7,6.5,3.8,2.7
09574132,"Hersbruck, St",09,Bayern,12260,6021,6239,1154,701,453,1695,944,751,9.4,5.7,3.7,13.8,7.7,6.1
09574135,Kirchensittenbach,09,Bayern,2033,1023,1010,177,100,77,89,52,37,8.7,4.9,3.8,4.4,2.6,1.8
09574138,"Lauf a.d.Pegnitz, St",09,Bayern,26344,12798,13546,2352,1374,978,2616,1584,1032,8.9,5.2,3.7,9.9,6.0,3.9
09574139,Leinburg,09,Bayern,6521,3218,3303,558,331,227,367,213,154,8.6,5.1,3.5,5.6,3.3,2.4
09574140,"Neuhaus a.d.Pegnitz, M",09,Bayern,2917,1470,1447,248,159,89,155,111,44,8.5,5.5,3.1,5.3,3.8,1.5
09574141,Neunkirchen a.Sand,09,Bayern,4686,2291,2395,425,271,154,272,143,129,9.1,5.8,3.3,5.8,3.1,2.8
09574146,Ottensoos,09,Bayern,2039,1011,1028,181,112,69,157,104,53,8.9,5.5,3.4,7.7,5.1,2.6
09574147,Pommelsbrunn,09,Bayern,5155,2582,2573,469,281,188,350,211,139,9.1,5.5,3.6,6.8,4.1,2.7
09574150,Reichenschwand,09,Bayern,2356,1150,1206,200,126,74,130,71,59,8.5,5.3,3.1,5.5,3.0,2.5
09574152,"Röthenbach a.d.Pegnitz, St",09,Bayern,11823,5665,6158,1067,623,444,759,430,329,9.0,5.3,3.8,6.4,3.6,2.8
09574154,Rückersdorf,09,Bayern,4533,2255,2278,348,202,146,402,259,143,7.7,4.5,3.2,8.9,5.7,3.2
09574155,"Schnaittach, M",09,Bayern,8245,4113,4132,759,477,282,506,318,188,9.2,5.8,3.4,6.1,3.9,2.3
09574156,Schwaig b.Nürnberg,09,Bayern,8593,4186,4407,739,431,308,1644,1086,558,8.6,5.0,3.6,19.1,12.6,6.5
09574157,Schwarzenbruck,09,Bayern,8364,4158,4206,639,399,240,476,284,192,7.6,4.8,2.9,5.7,3.4,2.3
09574158,Simmelsdorf,09,Bayern,3204,1656,1548,266,164,102,141,86,55,8.3,5.1,3.2,4.4,2.7,1.7
09574164,Winkelhaid,09,Bayern,4160,1993,2167,376,209,167,205,120,85,9.0,5.0,4.0,4.9,2.9,2.0
09574129,Hartenstein,09,Bayern,1472,762,710,133,74,59,-1,-1,-1,9.0,5.0,4.0,-0.1,,
09574160,"Velden, St",09,Bayern,1794,893,901,155,105,50,133,88,45,8.6,5.9,2.8,7.4,4.9,2.5
09574161,Vorra,09,Bayern,1718,851,867,141,78,63,-1,-1,-1,8.2,4.5,3.7,-0.1,,
09574111,Alfeld,09,Bayern,1074,536,538,125,80,45,118,61,57,11.6,7.4,4.2,11.0,5.7,5.3
09574128,Happurg,09,Bayern,3764,1890,1874,350,214,136,345,194,151,9.3,5.7,3.6,9.2,5.2,4.0
09574120,Engelthal,09,Bayern,1124,550,574,119,81,38,108,67,41,10.6,7.2,3.4,9.6,6.0,3.6
09574131,Henfenfeld,09,Bayern,1890,941,949,175,103,72,127,74,53,9.3,5.4,3.8,6.7,3.9,2.8
09574145,Offenhausen,09,Bayern,1544,769,775,144,81,63,102,58,44,9.3,5.2,4.1,6.6,3.8,2.8
09575112,"Bad Windsheim, St",09,Bayern,12047,5845,6202,1267,708,559,1898,1129,769,10.5,5.9,4.6,15.8,9.4,6.4
09575116,"Burghaslach, M",09,Bayern,2552,1257,1295,263,162,101,172,102,70,10.3,6.3,4.0,6.7,4.0,2.7
09575119,Dietersheim,09,Bayern,2218,1138,1080,223,138,85,140,72,68,10.1,6.2,3.8,6.3,3.2,3.1
09575121,"Emskirchen, M",09,Bayern,5956,3013,2943,555,345,210,454,250,204,9.3,5.8,3.5,7.6,4.2,3.4
09575135,"Ipsheim, M",09,Bayern,2107,1074,1033,218,125,93,148,90,58,10.3,5.9,4.4,7.0,4.3,2.8
09575145,"Markt Erlbach, M",09,Bayern,5620,2831,2789,544,319,225,380,229,151,9.7,5.7,4.0,6.8,4.1,2.7
09575153,"Neustadt a.d.Aisch, St",09,Bayern,12805,6166,6639,1373,808,565,1773,1051,722,10.7,6.3,4.4,13.8,8.2,5.6
09575156,"Obernzenn, M",09,Bayern,2714,1351,1363,228,135,93,148,88,60,8.4,5.0,3.4,5.5,3.2,2.2
09575138,Langenfeld,09,Bayern,1012,522,490,106,63,43,44,30,14,10.5,6.2,4.2,4.3,3.0,1.4
09575144,"Markt Bibart, M",09,Bayern,1905,984,921,164,107,57,150,86,64,8.6,5.6,3.0,7.9,4.5,3.4
09575147,"Markt Taschendorf, M",09,Bayern,992,508,484,95,63,32,94,52,42,9.6,6.4,3.2,9.5,5.2,4.2
09575157,"Oberscheinfeld, M",09,Bayern,1144,564,580,95,68,27,59,44,15,8.3,5.9,2.4,5.2,3.8,1.3
09575161,"Scheinfeld, St",09,Bayern,4586,2261,2325,427,250,177,294,183,111,9.3,5.5,3.9,6.4,4.0,2.4
09575165,"Sugenheim, M",09,Bayern,2255,1140,1115,242,170,72,159,99,60,10.7,7.5,3.2,7.1,4.4,2.7
09575122,Ergersheim,09,Bayern,1086,578,508,126,82,44,96,54,42,11.6,7.6,4.1,8.8,5.0,3.9
09575127,Gollhofen,09,Bayern,833,438,395,80,56,24,69,38,31,9.6,6.7,2.9,8.3,4.6,3.7
09575130,Hemmersheim,09,Bayern,648,341,307,72,43,29,65,42,23,11.1,6.6,4.5,10.0,6.5,3.5
09575134,"Ippesheim, M",09,Bayern,1087,554,533,95,60,35,123,68,55,8.7,5.5,3.2,11.3,6.3,5.1
09575146,"Markt Nordheim, M",09,Bayern,1150,564,586,104,74,30,97,58,39,9.0,6.4,2.6,8.4,5.0,3.4
09575155,Oberickelsheim,09,Bayern,693,360,333,82,53,29,41,31,10,11.8,7.6,4.2,5.9,4.5,1.4
09575163,Simmershofen,09,Bayern,877,476,401,95,65,30,71,41,30,10.8,7.4,3.4,8.1,4.7,3.4
09575168,"Uffenheim, St",09,Bayern,6320,3082,3238,615,386,229,596,395,201,9.7,6.1,3.6,9.4,6.2,3.2
09575179,Weigenheim,09,Bayern,979,493,486,106,67,39,44,30,14,10.8,6.8,4.0,4.5,3.1,1.4
09575129,Hagenbüchach,09,Bayern,1369,694,675,117,71,46,50,33,17,8.5,5.2,3.4,3.7,2.4,1.2
09575181,Wilhelmsdorf,09,Bayern,1482,762,720,156,92,64,118,70,48,10.5,6.2,4.3,8.0,4.7,3.2
09575113,"Baudenbach, M",09,Bayern,1171,587,584,123,80,43,71,40,31,10.5,6.8,3.7,6.1,3.4,2.6
09575118,Diespeck,09,Bayern,3659,1820,1839,358,198,160,267,155,112,9.8,5.4,4.4,7.3,4.2,3.1
09575128,Gutenstetten,09,Bayern,1308,666,642,130,81,49,65,39,26,9.9,6.2,3.7,5.0,3.0,2.0
09575150,Münchsteinach,09,Bayern,1356,689,667,138,88,50,73,51,22,10.2,6.5,3.7,5.4,3.8,1.6
09575117,"Dachsbach, M",09,Bayern,1705,860,845,153,94,59,109,74,35,9.0,5.5,3.5,6.4,4.3,2.1
09575125,Gerhardshofen,09,Bayern,2529,1285,1244,235,146,89,174,100,74,9.3,5.8,3.5,6.9,4.0,2.9
09575167,"Uehlfeld, M",09,Bayern,2912,1489,1423,297,163,134,217,116,101,10.2,5.6,4.6,7.5,4.0,3.5
09575115,"Burgbernheim, St",09,Bayern,3109,1534,1575,256,135,121,294,190,104,8.2,4.3,3.9,9.5,6.1,3.3
09575124,Gallmersgarten,09,Bayern,737,365,372,70,45,25,42,22,20,9.5,6.1,3.4,5.7,3.0,2.7
09575133,Illesheim,09,Bayern,876,434,442,79,51,28,30,17,13,9.0,5.8,3.2,3.4,1.9,1.5
09575143,"Marktbergel, M",09,Bayern,1547,791,756,155,93,62,100,62,38,10.0,6.0,4.0,6.5,4.0,2.5
09575152,"Neuhof a.d.Zenn, M",09,Bayern,2082,1043,1039,206,131,75,160,98,62,9.9,6.3,3.6,7.7,4.7,3.0
09575166,Trautskirchen,09,Bayern,1323,658,665,138,83,55,89,51,38,10.4,6.3,4.2,6.7,3.9,2.9
09576111,"Abenberg, St",09,Bayern,5541,2693,2848,546,331,215,396,231,165,9.9,6.0,3.9,7.1,4.2,3.0
09576113,"Allersberg, M",09,Bayern,8234,4121,4113,807,484,323,587,350,237,9.8,5.9,3.9,7.1,4.3,2.9
09576117,Büchenbach,09,Bayern,5286,2626,2660,468,278,190,283,147,136,8.9,5.3,3.6,5.4,2.8,2.6
09576121,Georgensgmünd,09,Bayern,6661,3366,3295,603,396,207,483,306,177,9.1,5.9,3.1,7.3,4.6,2.7
09576122,"Greding, St",09,Bayern,7061,3603,3458,732,483,249,579,364,215,10.4,6.8,3.5,8.2,5.2,3.0
09576126,"Heideck, St",09,Bayern,4642,2364,2278,498,293,205,359,188,171,10.7,6.3,4.4,7.7,4.0,3.7
09576127,"Hilpoltstein, St",09,Bayern,13287,6775,6512,1151,715,436,1302,876,426,8.7,5.4,3.3,9.8,6.6,3.2
09576128,Kammerstein,09,Bayern,2898,1466,1432,299,176,123,287,160,127,10.3,6.1,4.2,9.9,5.5,4.4
09576132,"Schwanstetten, M",09,Bayern,7276,3556,3720,609,364,245,368,225,143,8.4,5.0,3.4,5.1,3.1,2.0
09576137,Rednitzhembach,09,Bayern,6834,3367,3467,601,340,261,495,280,215,8.8,5.0,3.8,7.2,4.1,3.1
09576141,Röttenbach,09,Bayern,3126,1622,1504,273,161,112,179,116,63,8.7,5.2,3.6,5.7,3.7,2.0
09576142,Rohr,09,Bayern,3637,1797,1840,361,231,130,519,364,155,9.9,6.4,3.6,14.3,10.0,4.3
09576143,"Roth, St",09,Bayern,24819,12086,12733,2309,1346,963,2028,1208,820,9.3,5.4,3.9,8.2,4.9,3.3
09576147,"Spalt, St",09,Bayern,4988,2515,2473,504,308,196,491,285,206,10.1,6.2,3.9,9.8,5.7,4.1
09576148,"Thalmässing, M",09,Bayern,5151,2621,2530,523,321,202,371,226,145,10.2,6.2,3.9,7.2,4.4,2.8
09576151,"Wendelstein, M",09,Bayern,15699,7653,8046,1268,787,481,1268,785,483,8.1,5.0,3.1,8.1,5.0,3.1
09577114,Muhr a.See,09,Bayern,2223,1102,1121,204,121,83,175,107,68,9.2,5.4,3.7,7.9,4.8,3.1
09577136,"Gunzenhausen, St",09,Bayern,16432,7833,8599,1643,1001,642,1945,1185,760,10.0,6.1,3.9,11.8,7.2,4.6
09577148,Langenaltheim,09,Bayern,2227,1145,1082,252,155,97,120,78,42,11.3,7.0,4.4,5.4,3.5,1.9
09577158,"Pappenheim, St",09,Bayern,4049,2030,2019,426,257,169,414,277,137,10.5,6.3,4.2,10.2,6.8,3.4
09577161,"Pleinfeld, M",09,Bayern,7415,3690,3725,736,458,278,639,360,279,9.9,6.2,3.7,8.6,4.9,3.8
09577162,Polsingen,09,Bayern,1864,988,876,174,118,56,116,69,47,9.3,6.3,3.0,6.2,3.7,2.5
09577168,Solnhofen,09,Bayern,1717,911,806,172,115,57,136,92,44,10.0,6.7,3.3,7.9,5.4,2.6
09577173,"Treuchtlingen, St",09,Bayern,12781,6409,6372,1326,832,494,975,608,367,10.4,6.5,3.9,7.6,4.8,2.9
09577177,"Weißenburg i.Bay., GKSt",09,Bayern,17976,8806,9170,1858,1090,768,2341,1421,920,10.3,6.1,4.3,13.0,7.9,5.1
09577111,"Absberg, M",09,Bayern,1340,649,691,128,74,54,149,91,58,9.6,5.5,4.0,11.1,6.8,4.3
09577138,Haundorf,09,Bayern,2763,1433,1330,264,151,113,78,44,34,9.6,5.5,4.1,2.8,1.6,1.2
09577159,Pfofeld,09,Bayern,1528,781,747,148,84,64,133,72,61,9.7,5.5,4.2,8.7,4.7,4.0
09577172,Theilenhofen,09,Bayern,1129,574,555,129,69,60,112,65,47,11.4,6.1,5.3,9.9,5.8,4.2
09577113,Alesheim,09,Bayern,953,472,481,92,60,32,43,20,23,9.7,6.3,3.4,4.5,2.1,2.4
09577122,Dittenheim,09,Bayern,1770,922,848,191,113,78,107,56,51,10.8,6.4,4.4,6.0,3.2,2.9
09577149,"Markt Berolzheim, M",09,Bayern,1280,656,624,128,85,43,96,68,28,10.0,6.6,3.4,7.5,5.3,2.2
09577150,Meinheim,09,Bayern,842,444,398,108,61,47,78,45,33,12.8,7.2,5.6,9.3,5.3,3.9
09577125,"Ellingen, St",09,Bayern,3653,1842,1811,339,211,128,274,175,99,9.3,5.8,3.5,7.5,4.8,2.7
09577127,Ettenstatt,09,Bayern,840,417,423,104,68,36,89,53,36,12.4,8.1,4.3,10.6,6.3,4.3
09577141,Höttingen,09,Bayern,1148,574,574,142,87,55,103,53,50,12.4,7.6,4.8,9.0,4.6,4.4
09577115,Bergen,09,Bayern,1101,558,543,124,84,40,65,42,23,11.3,7.6,3.6,5.9,3.8,2.1
09577120,Burgsalach,09,Bayern,1150,612,538,120,71,49,90,50,40,10.4,6.2,4.3,7.8,4.3,3.5
09577151,"Nennslingen, M",09,Bayern,1385,716,669,154,92,62,105,67,38,11.1,6.6,4.5,7.6,4.8,2.7
09577163,Raitenbuch,09,Bayern,1206,644,562,110,75,35,37,22,15,9.1,6.2,2.9,3.1,1.8,1.2
09577133,"Gnotzheim, M",09,Bayern,822,406,416,74,45,29,42,25,17,9.0,5.5,3.5,5.1,3.0,2.1
09577140,"Heidenheim, M",09,Bayern,2607,1326,1281,241,158,83,113,75,38,9.2,6.1,3.2,4.3,2.9,1.5
09577179,Westheim,09,Bayern,1141,585,556,143,101,42,114,78,36,12.5,8.9,3.7,10.0,6.8,3.2
09661000,Aschaffenburg,09,Bayern,68986,33288,35698,7453,4640,2813,10891,6714,4177,10.8,6.7,4.1,15.8,9.7,6.1
09662000,Schweinfurt,09,Bayern,51969,25160,26809,5148,3399,1749,7211,4816,2395,9.9,6.5,3.4,13.9,9.3,4.6
09663000,Würzburg,09,Bayern,124873,59159,65714,15074,10440,4634,20610,14087,6523,12.1,8.4,3.7,16.5,11.3,5.2
09671111,"Alzenau, St",09,Bayern,18839,9393,9446,1749,1161,588,1860,1205,655,9.3,6.2,3.1,9.9,6.4,3.5
09671112,Bessenbach,09,Bayern,5678,2838,2840,679,401,278,473,294,179,12.0,7.1,4.9,8.3,5.2,3.2
09671114,Karlstein a.Main,09,Bayern,7968,3908,4060,747,482,265,1364,690,674,9.4,6.0,3.3,17.1,8.7,8.5
09671119,Geiselbach,09,Bayern,2044,1025,1019,182,126,56,87,66,21,8.9,6.2,2.7,4.3,3.2,1.0
09671120,Glattbach,09,Bayern,3295,1598,1697,345,212,133,234,136,98,10.5,6.4,4.0,7.1,4.1,3.0
09671121,"Goldbach, M",09,Bayern,9929,4931,4998,1136,709,427,927,597,330,11.4,7.1,4.3,9.3,6.0,3.3
09671122,"Großostheim, M",09,Bayern,16372,8149,8223,1715,1079,636,1523,1038,485,10.5,6.6,3.9,9.3,6.3,3.0
09671124,Haibach,09,Bayern,8498,4192,4306,834,526,308,672,397,275,9.8,6.2,3.6,7.9,4.7,3.2
09671130,"Hösbach, M",09,Bayern,13143,6507,6636,1580,980,600,1866,1104,762,12.0,7.5,4.6,14.2,8.4,5.8
09671133,Johannesberg,09,Bayern,3911,1975,1936,368,248,120,212,141,71,9.4,6.3,3.1,5.4,3.6,1.8
09671134,Kahl a.Main,09,Bayern,7555,3678,3877,616,365,251,554,371,183,8.2,4.8,3.3,7.3,4.9,2.4
09671136,Kleinostheim,09,Bayern,8218,4055,4163,837,530,307,940,604,336,10.2,6.4,3.7,11.4,7.3,4.1
09671139,Laufach,09,Bayern,5297,2691,2606,652,396,256,493,232,261,12.3,7.5,4.8,9.3,4.4,4.9
09671140,Mainaschaff,09,Bayern,8766,4315,4451,967,604,363,903,567,336,11.0,6.9,4.1,10.3,6.5,3.8
09671143,"Mömbris, M",09,Bayern,11576,5759,5817,1243,824,419,824,553,271,10.7,7.1,3.6,7.1,4.8,2.3
09671148,Rothenbuch,09,Bayern,1764,912,852,218,134,84,126,75,51,12.4,7.6,4.8,7.1,4.3,2.9
09671150,Sailauf,09,Bayern,3588,1794,1794,405,256,149,284,174,110,11.3,7.1,4.2,7.9,4.8,3.1
09671155,"Stockstadt a.Main, M",09,Bayern,7957,4027,3930,958,598,360,1018,530,488,12.0,7.5,4.5,12.8,6.7,6.1
09671156,Waldaschaff,09,Bayern,4034,2043,1991,444,265,179,234,149,85,11.0,6.6,4.4,5.8,3.7,2.1
09671157,Weibersbrunn,09,Bayern,2041,1050,991,216,129,87,145,89,56,10.6,6.3,4.3,7.1,4.4,2.7
09671126,Heigenbrücken,09,Bayern,2277,1170,1107,216,150,66,180,123,57,9.5,6.6,2.9,7.9,5.4,2.5
09671128,Heinrichsthal,09,Bayern,835,416,419,125,76,49,61,31,30,15.0,9.1,5.9,7.3,3.7,3.6
09671127,Heimbuchenthal,09,Bayern,2204,1110,1094,267,177,90,227,157,70,12.1,8.0,4.1,10.3,7.1,3.2
09671141,Mespelbrunn,09,Bayern,2237,1173,1064,248,177,71,176,116,60,11.1,7.9,3.2,7.9,5.2,2.7
09671160,Dammbach,09,Bayern,1883,951,932,232,158,74,99,60,39,12.3,8.4,3.9,5.3,3.2,2.1
09671113,Blankenbach,09,Bayern,1508,761,747,157,100,57,103,70,33,10.4,6.6,3.8,6.8,4.6,2.2
09671135,Kleinkahl,09,Bayern,1827,906,921,209,143,66,63,42,21,11.4,7.8,3.6,3.4,2.3,1.1
09671138,Krombach,09,Bayern,2129,1069,1060,250,164,86,365,224,141,11.7,7.7,4.0,17.1,10.5,6.6
09671152,"Schöllkrippen, M",09,Bayern,4206,2071,2135,480,317,163,596,394,202,11.4,7.5,3.9,14.2,9.4,4.8
09671153,Sommerkahl,09,Bayern,1149,563,586,131,88,43,90,63,27,11.4,7.7,3.7,7.8,5.5,2.3
09671159,Westerngrund,09,Bayern,1936,1001,935,221,152,69,96,63,33,11.4,7.9,3.6,5.0,3.3,1.7
09671162,Wiesen,09,Bayern,1031,512,519,134,81,53,110,65,45,13.0,7.9,5.1,10.7,6.3,4.4
09672112,"Bad Bocklet, M",09,Bayern,4565,2250,2315,419,274,145,377,234,143,9.2,6.0,3.2,8.3,5.1,3.1
09672113,"Bad Brückenau, St",09,Bayern,6412,3111,3301,613,385,228,816,546,270,9.6,6.0,3.6,12.7,8.5,4.2
09672114,"Bad Kissingen, GKSt",09,Bayern,21696,9921,11775,1991,1298,693,2906,1891,1015,9.2,6.0,3.2,13.4,8.7,4.7
09672117,"Burkardroth, M",09,Bayern,7570,3766,3804,831,528,303,462,296,166,11.0,7.0,4.0,6.1,3.9,2.2
09672127,"Hammelburg, St",09,Bayern,11135,5512,5623,1054,735,319,1087,751,336,9.5,6.6,2.9,9.8,6.7,3.0
09672134,Motten,09,Bayern,1771,889,882,215,143,72,161,104,57,12.1,8.1,4.1,9.1,5.9,3.2
09672135,"Münnerstadt, St",09,Bayern,7628,3897,3731,696,477,219,567,360,207,9.1,6.3,2.9,7.4,4.7,2.7
09672136,Nüdlingen,09,Bayern,3934,1971,1963,375,218,157,661,401,260,9.5,5.5,4.0,16.8,10.2,6.6
09672139,"Oberthulba, M",09,Bayern,5048,2542,2506,521,368,153,352,232,120,10.3,7.3,3.0,7.0,4.6,2.4
09672140,Oerlenbach,09,Bayern,5023,2505,2518,407,274,133,260,168,92,8.1,5.5,2.6,5.2,3.3,1.8
09672161,Wartmannsroth,09,Bayern,2104,1054,1050,199,138,61,141,114,27,9.5,6.6,2.9,6.7,5.4,1.3
09672163,"Wildflecken, M",09,Bayern,2968,1513,1455,270,193,77,197,134,63,9.1,6.5,2.6,6.6,4.5,2.1
09672166,"Zeitlofs, M",09,Bayern,2074,1032,1042,207,138,69,130,94,36,10.0,6.7,3.3,6.3,4.5,1.7
09672126,"Geroda, M",09,Bayern,835,417,418,85,64,21,20,16,4,10.2,7.7,2.5,2.4,1.9,0.5
09672138,Oberleichtersbach,09,Bayern,2062,1028,1034,245,179,66,206,135,71,11.9,8.7,3.2,10.0,6.5,3.4
09672145,Riedenberg,09,Bayern,991,493,498,66,43,23,40,23,17,6.7,4.3,2.3,4.0,2.3,1.7
09672149,"Schondra, M",09,Bayern,1726,898,828,190,123,67,147,88,59,11.0,7.1,3.9,8.5,5.1,3.4
09672121,"Elfershausen, M",09,Bayern,2822,1425,1397,269,198,71,172,125,47,9.5,7.0,2.5,6.1,4.4,1.7
09672124,Fuchsstadt,09,Bayern,1848,947,901,183,116,67,99,63,36,9.9,6.3,3.6,5.4,3.4,1.9
09672111,Aura a.d.Saale,09,Bayern,856,440,416,110,75,35,79,41,38,12.9,8.8,4.1,9.2,4.8,4.4
09672122,"Euerdorf, M",09,Bayern,1498,741,757,137,94,43,147,105,42,9.1,6.3,2.9,9.8,7.0,2.8
09672142,Ramsthal,09,Bayern,1093,553,540,102,72,30,43,27,16,9.3,6.6,2.7,3.9,2.5,1.5
09672155,"Sulzthal, M",09,Bayern,857,428,429,74,52,22,23,16,7,8.6,6.1,2.6,2.7,1.9,0.8
09672131,"Maßbach, M",09,Bayern,4431,2203,2228,402,287,115,361,277,84,9.1,6.5,2.6,8.1,6.3,1.9
09672143,Rannungen,09,Bayern,1118,575,543,114,83,31,53,33,20,10.2,7.4,2.8,4.7,3.0,1.8
09672157,Thundorf i.UFr.,09,Bayern,1041,512,529,103,79,24,70,44,26,9.9,7.6,2.3,6.7,4.2,2.5
09673114,"Bad Neustadt a.d.Saale, St",09,Bayern,15154,7233,7921,1325,862,463,2027,1327,700,8.7,5.7,3.1,13.4,8.8,4.6
09673116,Bastheim,09,Bayern,2042,1100,942,140,95,45,92,67,25,6.9,4.7,2.2,4.5,3.3,1.2
09673117,"Bischofsheim a.d.Rhön, St",09,Bayern,4698,2292,2406,409,285,124,367,246,121,8.7,6.1,2.6,7.8,5.2,2.6
09673141,"Bad Königshofen i.Grabfeld, St",09,Bayern,6034,2901,3133,551,394,157,707,507,200,9.1,6.5,2.6,11.7,8.4,3.3
09673149,"Oberelsbach, M",09,Bayern,2671,1349,1322,236,155,81,167,108,59,8.8,5.8,3.0,6.3,4.0,2.2
09673162,Sandberg,09,Bayern,2506,1245,1261,249,182,67,119,76,43,9.9,7.3,2.7,4.7,3.0,1.7
09673130,Hendungen,09,Bayern,908,478,430,73,56,17,69,52,17,8.0,6.2,1.9,7.6,5.7,1.9
09673142,"Mellrichstadt, St",09,Bayern,5563,2778,2785,534,370,164,713,480,233,9.6,6.7,2.9,12.8,8.6,4.2
09673151,Oberstreu,09,Bayern,1529,764,765,136,95,41,75,48,27,8.9,6.2,2.7,4.9,3.1,1.8
09673170,Stockheim,09,Bayern,1104,517,587,99,71,28,56,36,20,9.0,6.4,2.5,5.1,3.3,1.8
09673113,Aubstadt,09,Bayern,730,381,349,88,63,25,68,28,40,12.1,8.6,3.4,9.3,3.8,5.5
09673126,Großbardorf,09,Bayern,894,459,435,108,69,39,81,47,34,12.1,7.7,4.4,9.1,5.3,3.8
09673131,Herbstadt,09,Bayern,619,314,305,49,36,13,14,11,3,7.9,5.8,2.1,2.3,1.8,0.5
09673134,Höchheim,09,Bayern,1136,576,560,113,84,29,58,43,15,9.9,7.4,2.6,5.1,3.8,1.3
09673172,Sulzdorf a.d.Lederhecke,09,Bayern,1112,582,530,137,97,40,50,29,21,12.3,8.7,3.6,4.5,2.6,1.9
09673173,Sulzfeld,09,Bayern,1661,845,816,147,101,46,87,66,21,8.9,6.1,2.8,5.2,4.0,1.3
09673174,"Trappstadt, M",09,Bayern,991,526,465,105,67,38,87,48,39,10.6,6.8,3.8,8.8,4.8,3.9
09673135,Hohenroth,09,Bayern,3458,1755,1703,317,197,120,197,107,90,9.2,5.7,3.5,5.7,3.1,2.6
09673146,Niederlauer,09,Bayern,1664,815,849,165,97,68,136,84,52,9.9,5.8,4.1,8.2,5.0,3.1
09673156,Rödelmaier,09,Bayern,927,459,468,92,61,31,31,21,10,9.9,6.6,3.3,3.3,2.3,1.1
09673161,Salz,09,Bayern,2349,1165,1184,201,126,75,231,144,87,8.6,5.4,3.2,9.8,6.1,3.7
09673163,Schönau a.d.Brend,09,Bayern,1237,597,640,116,82,34,60,44,16,9.4,6.6,2.7,4.9,3.6,1.3
09673171,Strahlungen,09,Bayern,911,463,448,103,61,42,51,29,22,11.3,6.7,4.6,5.6,3.2,2.4
09673186,Burglauer,09,Bayern,1649,828,821,187,109,78,112,63,49,11.3,6.6,4.7,6.8,3.8,3.0
09673123,"Fladungen, St",09,Bayern,2322,1173,1149,182,133,49,159,116,43,7.8,5.7,2.1,6.8,5.0,1.9
09673129,Hausen,09,Bayern,722,383,339,53,38,15,81,57,24,7.3,5.3,2.1,11.2,7.9,3.3
09673147,Nordheim v.d.Rhön,09,Bayern,1121,563,558,92,59,33,54,32,22,8.2,5.3,2.9,4.8,2.9,2.0
09673133,Heustreu,09,Bayern,1252,631,621,117,82,35,74,55,19,9.3,6.5,2.8,5.9,4.4,1.5
09673136,Hollstadt,09,Bayern,1524,760,764,141,86,55,58,30,28,9.3,5.6,3.6,3.8,2.0,1.8
09673175,Unsleben,09,Bayern,939,470,469,77,48,29,74,42,32,8.2,5.1,3.1,7.9,4.5,3.4
09673183,Wollbach,09,Bayern,1298,642,656,118,81,37,70,52,18,9.1,6.2,2.9,5.4,4.0,1.4
09673153,"Ostheim v.d.Rhön, St",09,Bayern,3388,1688,1700,367,256,111,310,224,86,10.8,7.6,3.3,9.1,6.6,2.5
09673167,Sondheim v.d.Rhön,09,Bayern,928,466,462,89,49,40,48,29,19,9.6,5.3,4.3,5.2,3.1,2.0
09673182,Willmars,09,Bayern,620,312,308,39,31,8,21,17,4,6.3,5.0,1.3,3.4,2.7,0.6
09673127,Großeibstadt,09,Bayern,1114,558,556,119,73,46,59,34,25,10.7,6.6,4.1,5.3,3.1,2.2
09673160,"Saal a.d.Saale, M",09,Bayern,1475,723,752,141,90,51,137,95,42,9.6,6.1,3.5,9.3,6.4,2.8
09673184,Wülfershausen a.d.Saale,09,Bayern,1473,749,724,142,96,46,105,72,33,9.6,6.5,3.1,7.1,4.9,2.2
09674133,"Eltmann, St",09,Bayern,5280,2676,2604,530,333,197,392,239,153,10.0,6.3,3.7,7.4,4.5,2.9
09674147,"Haßfurt, St",09,Bayern,13277,6531,6746,1660,1053,607,3550,2410,1140,12.5,7.9,4.6,26.7,18.2,8.6
09674159,Oberaurach,09,Bayern,3971,1996,1975,442,290,152,257,180,77,11.1,7.3,3.8,6.5,4.5,1.9
09674163,Knetzgau,09,Bayern,6396,3225,3171,760,508,252,550,347,203,11.9,7.9,3.9,8.6,5.4,3.2
09674164,"Königsberg i.Bay., St",09,Bayern,3596,1779,1817,381,272,109,240,158,82,10.6,7.6,3.0,6.7,4.4,2.3
09674171,"Maroldsweisach, M",09,Bayern,3339,1656,1683,375,237,138,316,214,102,11.2,7.1,4.1,9.5,6.4,3.1
09674187,Rauhenebrach,09,Bayern,2947,1525,1422,311,220,91,144,93,51,10.6,7.5,3.1,4.9,3.2,1.7
09674195,Sand a.Main,09,Bayern,3121,1568,1553,379,251,128,246,130,116,12.1,8.0,4.1,7.9,4.2,3.7
09674210,Untermerzbach,09,Bayern,1696,866,830,144,102,42,111,68,43,8.5,6.0,2.5,6.5,4.0,2.5
09674221,"Zeil a.Main, St",09,Bayern,5597,2757,2840,637,407,230,558,367,191,11.4,7.3,4.1,10.0,6.6,3.4
09674118,Breitbrunn,09,Bayern,1092,567,525,108,74,34,26,16,10,9.9,6.8,3.1,2.4,1.5,0.9
09674129,Ebelsbach,09,Bayern,3805,1930,1875,430,286,144,274,189,85,11.3,7.5,3.8,7.2,5.0,2.2
09674160,Kirchlauter,09,Bayern,1318,668,650,135,105,30,180,123,57,10.2,8.0,2.3,13.7,9.3,4.3
09674201,Stettfeld,09,Bayern,1145,570,575,112,73,39,54,31,23,9.8,6.4,3.4,4.7,2.7,2.0
09674130,"Ebern, St",09,Bayern,7408,3760,3648,749,481,268,665,435,230,10.1,6.5,3.6,9.0,5.9,3.1
09674184,Pfarrweisach,09,Bayern,1487,748,739,130,97,33,53,36,17,8.7,6.5,2.2,3.6,2.4,1.1
09674190,"Rentweinsdorf, M",09,Bayern,1561,758,803,163,100,63,62,32,30,10.4,6.4,4.0,4.0,2.0,1.9
09674111,Aidhausen,09,Bayern,1787,917,870,205,141,64,93,57,36,11.5,7.9,3.6,5.2,3.2,2.0
09674120,Bundorf,09,Bayern,919,474,445,102,71,31,35,22,13,11.1,7.7,3.4,3.8,2.4,1.4
09674121,"Burgpreppach, M",09,Bayern,1406,702,704,172,114,58,138,78,60,12.2,8.1,4.1,9.8,5.5,4.3
09674149,"Hofheim i.UFr., St",09,Bayern,5143,2552,2591,556,381,175,587,404,183,10.8,7.4,3.4,11.4,7.9,3.6
09674153,Riedbach,09,Bayern,1735,879,856,206,150,56,61,43,18,11.9,8.6,3.2,3.5,2.5,1.0
09674223,Ermershausen,09,Bayern,573,296,277,76,52,24,38,24,14,13.3,9.1,4.2,6.6,4.2,2.4
09674139,Gädheim,09,Bayern,1291,662,629,97,67,30,24,15,9,7.5,5.2,2.3,1.9,1.2,0.7
09674180,Theres,09,Bayern,2718,1358,1360,261,172,89,128,70,58,9.6,6.3,3.3,4.7,2.6,2.1
09674219,Wonfurt,09,Bayern,1973,992,981,218,155,63,117,81,36,11.0,7.9,3.2,5.9,4.1,1.8
09675117,"Dettelbach, St",09,Bayern,6968,3481,3487,717,482,235,729,433,296,10.3,6.9,3.4,10.5,6.2,4.2
09675127,"Geiselwind, M",09,Bayern,2416,1227,1189,246,158,88,211,132,79,10.2,6.5,3.6,8.7,5.5,3.3
09675141,"Kitzingen, GKSt",09,Bayern,20756,10087,10669,2164,1325,839,2349,1520,829,10.4,6.4,4.0,11.3,7.3,4.0
09675144,"Mainbernheim, St",09,Bayern,2202,1105,1097,218,127,91,126,77,49,9.9,5.8,4.1,5.7,3.5,2.2
09675158,"Prichsenstadt, St",09,Bayern,3139,1600,1539,332,210,122,319,193,126,10.6,6.7,3.9,10.2,6.1,4.0
09675165,"Schwarzach a.Main, M",09,Bayern,3574,1877,1697,331,193,138,434,285,149,9.3,5.4,3.9,12.1,8.0,4.2
09675111,"Abtswind, M",09,Bayern,851,429,422,94,65,29,107,74,33,11.0,7.6,3.4,12.6,8.7,3.9
09675116,Castell,09,Bayern,819,427,392,89,62,27,105,71,34,10.9,7.6,3.3,12.8,8.7,4.2
09675162,"Rüdenhausen, M",09,Bayern,876,439,437,102,60,42,86,53,33,11.6,6.8,4.8,9.8,6.1,3.8
09675178,"Wiesentheid, M",09,Bayern,4775,2362,2413,519,323,196,507,302,205,10.9,6.8,4.1,10.6,6.3,4.3
09675131,"Großlangheim, M",09,Bayern,1606,805,801,174,96,78,89,54,35,10.8,6.0,4.9,5.5,3.4,2.2
09675142,"Kleinlangheim, M",09,Bayern,1734,928,806,162,110,52,94,60,34,9.3,6.3,3.0,5.4,3.5,2.0
09675177,Wiesenbronn,09,Bayern,1052,562,490,109,66,43,55,27,28,10.4,6.3,4.1,5.2,2.6,2.7
09675139,"Iphofen, St",09,Bayern,4584,2282,2302,447,299,148,401,295,106,9.8,6.5,3.2,8.7,6.4,2.3
09675148,"Markt Einersheim, M",09,Bayern,1187,597,590,122,73,49,86,60,26,10.3,6.1,4.1,7.2,5.1,2.2
09675161,Rödelsee,09,Bayern,1738,856,882,178,116,62,142,93,49,10.2,6.7,3.6,8.2,5.4,2.8
09675179,"Willanzheim, M",09,Bayern,1598,847,751,170,108,62,78,37,41,10.6,6.8,3.9,4.9,2.3,2.6
09675112,Albertshofen,09,Bayern,2257,1168,1089,247,150,97,137,82,55,10.9,6.6,4.3,6.1,3.6,2.4
09675113,Biebelried,09,Bayern,1256,658,598,133,81,52,68,46,22,10.6,6.4,4.1,5.4,3.7,1.8
09675114,Buchbrunn,09,Bayern,1128,562,566,100,66,34,125,80,45,8.9,5.9,3.0,11.1,7.1,4.0
09675146,Mainstockheim,09,Bayern,1950,972,978,210,121,89,100,77,23,10.8,6.2,4.6,5.1,3.9,1.2
09675170,Sulzfeld a.Main,09,Bayern,1329,664,665,162,96,66,98,55,43,12.2,7.2,5.0,7.4,4.1,3.2
09675147,"Marktbreit, St",09,Bayern,3834,2017,1817,358,220,138,493,321,172,9.3,5.7,3.6,12.9,8.4,4.5
09675149,"Marktsteft, St",09,Bayern,1939,1001,938,192,111,81,208,79,129,9.9,5.7,4.2,10.7,4.1,6.7
09675150,Martinsheim,09,Bayern,1067,564,503,115,72,43,38,26,12,10.8,6.7,4.0,3.6,2.4,1.1
09675156,"Obernbreit, M",09,Bayern,1712,844,868,164,107,57,116,83,33,9.6,6.2,3.3,6.8,4.8,1.9
09675166,Segnitz,09,Bayern,851,423,428,93,66,27,53,37,16,10.9,7.8,3.2,6.2,4.3,1.9
09675167,"Seinsheim, M",09,Bayern,1059,534,525,107,61,46,21,15,6,10.1,5.8,4.3,2.0,1.4,0.6
09675155,Nordheim a.Main,09,Bayern,993,510,483,116,80,36,128,88,40,11.7,8.1,3.6,12.9,8.9,4.0
09675169,Sommerach,09,Bayern,1335,657,678,154,109,45,130,95,35,11.5,8.2,3.4,9.7,7.1,2.6
09675174,"Volkach, St",09,Bayern,8721,4311,4410,957,639,318,990,657,333,11.0,7.3,3.6,11.4,7.5,3.8
09676112,"Amorbach, St",09,Bayern,3984,1964,2020,425,282,143,410,297,113,10.7,7.1,3.6,10.3,7.5,2.8
09676117,Collenberg,09,Bayern,2470,1265,1205,291,204,87,222,136,86,11.8,8.3,3.5,9.0,5.5,3.5
09676118,Dorfprozelten,09,Bayern,1761,906,855,203,142,61,147,97,50,11.5,8.1,3.5,8.3,5.5,2.8
09676119,Eichenbühl,09,Bayern,2545,1285,1260,329,204,125,180,107,73,12.9,8.0,4.9,7.1,4.2,2.9
09676121,"Elsenfeld, M",09,Bayern,9015,4515,4500,918,588,330,875,588,287,10.2,6.5,3.7,9.7,6.5,3.2
09676122,"Erlenbach a.Main, St",09,Bayern,9996,4970,5026,1012,623,389,753,472,281,10.1,6.2,3.9,7.5,4.7,2.8
09676123,"Eschau, M",09,Bayern,3778,1925,1853,381,260,121,249,168,81,10.1,6.9,3.2,6.6,4.4,2.1
09676124,Faulbach,09,Bayern,2588,1302,1286,313,193,120,204,127,77,12.1,7.5,4.6,7.9,4.9,3.0
09676125,"Großheubach, M",09,Bayern,5114,2510,2604,601,393,208,735,428,307,11.8,7.7,4.1,14.4,8.4,6.0
09676126,Großwallstadt,09,Bayern,4118,2016,2102,476,304,172,608,355,253,11.6,7.4,4.2,14.8,8.6,6.1
09676131,"Kirchzell, M",09,Bayern,2233,1145,1088,279,200,79,150,107,43,12.5,9.0,3.5,6.7,4.8,1.9
09676134,"Klingenberg a.Main, St",09,Bayern,6112,3040,3072,612,377,235,556,368,188,10.0,6.2,3.8,9.1,6.0,3.1
09676136,Leidersbach,09,Bayern,4788,2429,2359,589,378,211,450,306,144,12.3,7.9,4.4,9.4,6.4,3.0
09676139,"Miltenberg, St",09,Bayern,9372,4595,4777,1052,654,398,1458,949,509,11.2,7.0,4.2,15.6,10.1,5.4
09676140,Mömlingen,09,Bayern,4948,2475,2473,470,292,178,366,226,140,9.5,5.9,3.6,7.4,4.6,2.8
09676144,Niedernberg,09,Bayern,4993,2499,2494,570,344,226,1376,955,421,11.4,6.9,4.5,27.6,19.1,8.4
09676145,"Obernburg a.Main, St",09,Bayern,8477,4197,4280,810,509,301,1073,744,329,9.6,6.0,3.6,12.7,8.8,3.9
09676156,"Schneeberg, M",09,Bayern,1785,890,895,201,125,76,98,58,40,11.3,7.0,4.3,5.5,3.2,2.2
09676160,"Sulzbach a.Main, M",09,Bayern,7125,3555,3570,860,521,339,507,326,181,12.1,7.3,4.8,7.1,4.6,2.5
09676165,"Weilbach, M",09,Bayern,2200,1121,1079,241,171,70,163,120,43,11.0,7.8,3.2,7.4,5.5,2.0
09676169,"Wörth a.Main, St",09,Bayern,4699,2322,2377,439,262,177,395,240,155,9.3,5.6,3.8,8.4,5.1,3.3
09676116,"Bürgstadt, M",09,Bayern,4284,2147,2137,516,313,203,514,313,201,12.0,7.3,4.7,12.0,7.3,4.7
09676143,Neunkirchen,09,Bayern,1511,761,750,195,120,75,99,63,36,12.9,7.9,5.0,6.6,4.2,2.4
09676132,"Kleinheubach, M",09,Bayern,3657,1813,1844,423,243,180,549,328,221,11.6,6.6,4.9,15.0,9.0,6.0
09676135,Laudenbach,09,Bayern,1424,711,713,149,94,55,92,57,35,10.5,6.6,3.9,6.5,4.0,2.5
09676153,Rüdenau,09,Bayern,749,369,380,82,53,29,40,24,16,10.9,7.1,3.9,5.3,3.2,2.1
09676128,Hausen,09,Bayern,1859,936,923,232,145,87,48,30,18,12.5,7.8,4.7,2.6,1.6,1.0
09676133,"Kleinwallstadt, M",09,Bayern,5781,2817,2964,597,359,238,416,235,181,10.3,6.2,4.1,7.2,4.1,3.1
09676141,"Mönchberg, M",09,Bayern,2596,1304,1292,253,173,80,159,108,51,9.7,6.7,3.1,6.1,4.2,2.0
09676151,Röllbach,09,Bayern,1692,861,831,196,132,64,96,66,30,11.6,7.8,3.8,5.7,3.9,1.8
09676111,Altenbuch,09,Bayern,1242,614,628,155,107,48,59,38,21,12.5,8.6,3.9,4.8,3.1,1.7
09676158,"Stadtprozelten, St",09,Bayern,1550,803,747,167,114,53,100,70,30,10.8,7.4,3.4,6.5,4.5,1.9
09677114,"Arnstein, St",09,Bayern,8161,4132,4029,739,477,262,562,382,180,9.1,5.8,3.2,6.9,4.7,2.2
09677127,Eußenheim,09,Bayern,3194,1631,1563,347,232,115,176,123,53,10.9,7.3,3.6,5.5,3.9,1.7
09677129,"Frammersbach, M",09,Bayern,4545,2295,2250,553,359,194,530,325,205,12.2,7.9,4.3,11.7,7.2,4.5
09677131,"Gemünden a.Main, St",09,Bayern,10069,5016,5053,971,662,309,924,662,262,9.6,6.6,3.1,9.2,6.6,2.6
09677148,"Karlstadt, St",09,Bayern,14808,7290,7518,1405,927,478,1285,843,442,9.5,6.3,3.2,8.7,5.7,3.0
09677154,"Triefenstein, M",09,Bayern,4332,2167,2165,451,275,176,268,161,107,10.4,6.3,4.1,6.2,3.7,2.5
09677155,"Lohr a.Main, St",09,Bayern,15060,7427,7633,1353,860,493,1634,1079,555,9.0,5.7,3.3,10.8,7.2,3.7
09677157,"Marktheidenfeld, St",09,Bayern,10967,5322,5645,1282,770,512,2432,1579,853,11.7,7.0,4.7,22.2,14.4,7.8
09677177,"Rieneck, St",09,Bayern,1987,966,1021,188,130,58,165,101,64,9.5,6.5,2.9,8.3,5.1,3.2
09677137,Hasloch,09,Bayern,1398,734,664,178,108,70,80,58,22,12.7,7.7,5.0,5.7,4.1,1.6
09677151,"Kreuzwertheim, M",09,Bayern,3819,1897,1922,432,253,179,498,306,192,11.3,6.6,4.7,13.0,8.0,5.0
09677182,Schollbrunn,09,Bayern,955,508,447,114,66,48,101,40,61,11.9,6.9,5.0,10.6,4.2,6.4
09677119,Birkenfeld,09,Bayern,2121,1087,1034,202,132,70,92,67,25,9.5,6.2,3.3,4.3,3.2,1.2
09677120,Bischbrunn,09,Bayern,1796,903,893,204,134,70,80,47,33,11.4,7.5,3.9,4.5,2.6,1.8
09677125,Erlenbach b.Marktheidenfeld,09,Bayern,2364,1193,1171,270,190,80,134,93,41,11.4,8.0,3.4,5.7,3.9,1.7
09677126,Esselbach,09,Bayern,2051,978,1073,276,164,112,168,102,66,13.5,8.0,5.5,8.2,5.0,3.2
09677135,Hafenlohr,09,Bayern,1860,946,914,185,104,81,136,74,62,9.9,5.6,4.4,7.3,4.0,3.3
09677146,"Karbach, M",09,Bayern,1439,711,728,171,99,72,64,31,33,11.9,6.9,5.0,4.4,2.2,2.3
09677178,Roden,09,Bayern,1006,518,488,103,62,41,34,20,14,10.2,6.2,4.1,3.4,2.0,1.4
09677181,"Rothenfels, St",09,Bayern,1004,524,480,103,65,38,40,23,17,10.3,6.5,3.8,4.0,2.3,1.7
09677193,Urspringen,09,Bayern,1344,678,666,153,85,68,74,42,32,11.4,6.3,5.1,5.5,3.1,2.4
09677116,Aura i.Sinngrund,09,Bayern,1010,498,512,105,72,33,57,30,27,10.4,7.1,3.3,5.6,3.0,2.7
09677122,"Burgsinn, M",09,Bayern,2436,1228,1208,233,159,74,175,124,51,9.6,6.5,3.0,7.2,5.1,2.1
09677128,Fellen,09,Bayern,859,421,438,93,61,32,54,34,20,10.8,7.1,3.7,6.3,4.0,2.3
09677159,Mittelsinn,09,Bayern,812,406,406,66,41,25,45,29,16,8.1,5.0,3.1,5.5,3.6,2.0
09677169,"Obersinn, M",09,Bayern,970,494,476,115,77,38,69,39,30,11.9,7.9,3.9,7.1,4.0,3.1
09677132,Gössenheim,09,Bayern,1179,596,583,115,84,31,102,70,32,9.8,7.1,2.6,8.7,5.9,2.7
09677133,Gräfendorf,09,Bayern,1395,719,676,144,93,51,89,62,27,10.3,6.7,3.7,6.4,4.4,1.9
09677149,Karsbach,09,Bayern,1743,874,869,181,117,64,70,46,24,10.4,6.7,3.7,4.0,2.6,1.4
09677164,Neuendorf,09,Bayern,830,427,403,72,51,21,23,17,6,8.7,6.1,2.5,2.8,2.0,0.7
09677166,Neustadt a.Main,09,Bayern,1288,640,648,82,60,22,189,141,48,6.4,4.7,1.7,14.7,10.9,3.7
09677172,Rechtenbach,09,Bayern,1003,501,502,98,72,26,27,20,7,9.8,7.2,2.6,2.7,2.0,0.7
09677186,Steinfeld,09,Bayern,2187,1119,1068,178,131,47,103,68,35,8.1,6.0,2.1,4.7,3.1,1.6
09677142,Himmelstadt,09,Bayern,1592,817,775,184,114,70,109,71,38,11.6,7.2,4.4,6.8,4.5,2.4
09677175,Retzstadt,09,Bayern,1546,779,767,148,99,49,69,40,29,9.6,6.4,3.2,4.5,2.6,1.9
09677189,"Thüngen, M",09,Bayern,1332,645,687,123,85,38,112,61,51,9.2,6.4,2.9,8.4,4.6,3.8
09677203,"Zellingen, M",09,Bayern,6336,3127,3209,658,416,242,756,457,299,10.4,6.6,3.8,11.9,7.2,4.7
09677165,Neuhütten,09,Bayern,1167,573,594,124,82,42,44,31,13,10.6,7.0,3.6,3.8,2.7,1.1
09677170,Partenstein,09,Bayern,2806,1403,1403,277,182,95,172,117,55,9.9,6.5,3.4,6.1,4.2,2.0
09677200,Wiesthal,09,Bayern,1352,666,686,143,93,50,93,65,28,10.6,6.9,3.7,6.9,4.8,2.1
09678115,Bergrheinfeld,09,Bayern,5334,2639,2695,482,335,147,377,292,85,9.0,6.3,2.8,7.1,5.5,1.6
09678123,Dittelbrunn,09,Bayern,7308,3613,3695,570,371,199,250,155,95,7.8,5.1,2.7,3.4,2.1,1.3
09678128,Euerbach,09,Bayern,3047,1529,1518,253,154,99,284,142,142,8.3,5.1,3.2,9.3,4.7,4.7
09678132,Geldersheim,09,Bayern,2967,1496,1471,236,134,102,146,86,60,8.0,4.5,3.4,4.9,2.9,2.0
09678135,Gochsheim,09,Bayern,6240,3067,3173,575,365,210,521,320,201,9.2,5.8,3.4,8.3,5.1,3.2
09678136,Grafenrheinfeld,09,Bayern,3440,1704,1736,352,235,117,242,162,80,10.2,6.8,3.4,7.0,4.7,2.3
09678138,Grettstadt,09,Bayern,4211,2116,2095,358,223,135,149,88,61,8.5,5.3,3.2,3.5,2.1,1.4
09678150,Kolitzheim,09,Bayern,5463,2741,2722,522,319,203,276,170,106,9.6,5.8,3.7,5.1,3.1,1.9
09678160,Niederwerrn,09,Bayern,7871,3905,3966,734,452,282,300,168,132,9.3,5.7,3.6,3.8,2.1,1.7
09678168,Poppenhausen,09,Bayern,4364,2186,2178,347,232,115,182,128,54,8.0,5.3,2.6,4.2,2.9,1.2
09678170,Röthlein,09,Bayern,4561,2247,2314,381,258,123,319,200,119,8.4,5.7,2.7,7.0,4.4,2.6
09678174,Schonungen,09,Bayern,7701,3866,3835,644,416,228,386,252,134,8.4,5.4,3.0,5.0,3.3,1.7
09678176,Schwebheim,09,Bayern,4164,2055,2109,361,220,141,380,210,170,8.7,5.3,3.4,9.1,5.0,4.1
09678178,Sennfeld,09,Bayern,4462,2222,2240,410,259,151,505,323,182,9.2,5.8,3.4,11.3,7.2,4.1
09678181,"Stadtlauringen, M",09,Bayern,4055,2026,2029,371,238,133,302,203,99,9.1,5.9,3.3,7.4,5.0,2.4
09678186,Üchtelhausen,09,Bayern,3880,1955,1925,310,212,98,140,78,62,8.0,5.5,2.5,3.6,2.0,1.6
09678190,Waigolshausen,09,Bayern,2770,1409,1361,200,124,76,79,61,18,7.2,4.5,2.7,2.9,2.2,0.6
09678192,Wasserlosen,09,Bayern,3404,1737,1667,282,193,89,105,75,30,8.3,5.7,2.6,3.1,2.2,0.9
09678193,"Werneck, M",09,Bayern,10206,5149,5057,830,530,300,843,532,311,8.1,5.2,2.9,8.3,5.2,3.0
09678122,Dingolshausen,09,Bayern,1322,671,651,117,80,37,58,34,24,8.9,6.1,2.8,4.4,2.6,1.8
09678124,Donnersdorf,09,Bayern,1946,1004,942,191,128,63,117,72,45,9.8,6.6,3.2,6.0,3.7,2.3
09678130,Frankenwinheim,09,Bayern,975,489,486,103,67,36,-1,-1,-1,10.6,6.9,3.7,-0.1,,
09678134,"Gerolzhofen, St",09,Bayern,6902,3382,3520,687,446,241,1072,700,372,10.0,6.5,3.5,15.5,10.1,5.4
09678153,Lülsfeld,09,Bayern,793,404,389,85,52,33,-1,-1,-1,10.7,6.6,4.2,-0.1,,
09678157,Michelau i.Steigerwald,09,Bayern,1104,559,545,107,75,32,47,23,24,9.7,6.8,2.9,4.3,2.1,2.2
09678164,"Oberschwarzach, M",09,Bayern,1388,716,672,110,74,36,80,46,34,7.9,5.3,2.6,5.8,3.3,2.4
09678183,Sulzheim,09,Bayern,2069,1101,968,160,104,56,99,60,39,7.7,5.0,2.7,4.8,2.9,1.9
09678175,Schwanfeld,09,Bayern,1809,900,909,169,115,54,126,82,44,9.3,6.4,3.0,7.0,4.5,2.4
09678196,Wipfeld,09,Bayern,1057,518,539,101,74,27,78,52,26,9.6,7.0,2.6,7.4,4.9,2.5
09679126,Eisingen,09,Bayern,3372,1655,1717,356,219,137,259,181,78,10.6,6.5,4.1,7.7,5.4,2.3
09679134,Gaukönigshofen,09,Bayern,2508,1305,1203,266,166,100,110,62,48,10.6,6.6,4.0,4.4,2.5,1.9
09679136,Gerbrunn,09,Bayern,6235,3053,3182,644,438,206,352,215,137,10.3,7.0,3.3,5.6,3.4,2.2
09679142,Güntersleben,09,Bayern,4403,2166,2237,434,229,205,194,99,95,9.9,5.2,4.7,4.4,2.2,2.2
09679143,Hausen b.Würzburg,09,Bayern,2429,1232,1197,254,159,95,170,121,49,10.5,6.5,3.9,7.0,5.0,2.0
09679147,"Höchberg, M",09,Bayern,9329,4474,4855,826,536,290,668,448,220,8.9,5.7,3.1,7.2,4.8,2.4
09679155,Kleinrinderfeld,09,Bayern,2089,1084,1005,231,138,93,110,71,39,11.1,6.6,4.5,5.3,3.4,1.9
09679156,Kürnach,09,Bayern,4796,2320,2476,413,265,148,365,242,123,8.6,5.5,3.1,7.6,5.0,2.6
09679164,"Neubrunn, M",09,Bayern,2243,1137,1106,222,149,73,150,109,41,9.9,6.6,3.3,6.7,4.9,1.8
09679170,"Ochsenfurt, St",09,Bayern,11155,5515,5640,1179,760,419,961,613,348,10.6,6.8,3.8,8.6,5.5,3.1
09679175,"Randersacker, M",09,Bayern,3403,1663,1740,289,180,109,201,125,76,8.5,5.3,3.2,5.9,3.7,2.2
09679176,"Reichenberg, M",09,Bayern,4075,2035,2040,395,256,139,355,204,151,9.7,6.3,3.4,8.7,5.0,3.7
09679180,"Rimpar, M",09,Bayern,7530,3730,3800,768,482,286,426,272,154,10.2,6.4,3.8,5.7,3.6,2.0
09679185,Rottendorf,09,Bayern,5354,2604,2750,542,329,213,796,563,233,10.1,6.1,4.0,14.9,10.5,4.4
09679193,Theilheim,09,Bayern,2313,1132,1181,236,151,85,64,44,20,10.2,6.5,3.7,2.8,1.9,0.9
09679194,Thüngersheim,09,Bayern,2689,1365,1324,217,158,59,144,110,34,8.1,5.9,2.2,5.4,4.1,1.3
09679200,Leinach,09,Bayern,3092,1559,1533,347,238,109,119,79,40,11.2,7.7,3.5,3.8,2.6,1.3
09679201,Unterpleichfeld,09,Bayern,3041,1577,1464,304,184,120,390,163,227,10.0,6.1,3.9,12.8,5.4,7.5
09679202,Veitshöchheim,09,Bayern,9673,4731,4942,973,591,382,877,544,333,10.1,6.1,3.9,9.1,5.6,3.4
09679204,Waldbrunn,09,Bayern,2707,1341,1366,255,167,88,86,55,31,9.4,6.2,3.3,3.2,2.0,1.1
09679205,Waldbüttelbrunn,09,Bayern,4866,2437,2429,495,311,184,961,585,376,10.2,6.4,3.8,19.7,12.0,7.7
09679209,"Zell a.Main, M",09,Bayern,4299,2062,2237,366,211,155,380,274,106,8.5,4.9,3.6,8.8,6.4,2.5
09679114,"Aub, St",09,Bayern,1506,777,729,161,100,61,169,109,60,10.7,6.6,4.1,11.2,7.2,4.0
09679135,"Gelchsheim, M",09,Bayern,801,420,381,87,59,28,62,36,26,10.9,7.4,3.5,7.7,4.5,3.2
09679188,Sonderhofen,09,Bayern,848,452,396,96,71,25,62,44,18,11.3,8.4,2.9,7.3,5.2,2.1
09679117,Bergtheim,09,Bayern,3608,1790,1818,366,235,131,230,149,81,10.1,6.5,3.6,6.4,4.1,2.2
09679169,Oberpleichfeld,09,Bayern,1070,562,508,123,78,45,39,26,13,11.5,7.3,4.2,3.6,2.4,1.2
09679124,"Eibelstadt, St",09,Bayern,3022,1453,1569,264,172,92,390,254,136,8.7,5.7,3.0,12.9,8.4,4.5
09679131,"Frickenhausen a.Main, M",09,Bayern,1229,598,631,124,84,40,87,50,37,10.1,6.8,3.3,7.1,4.1,3.0
09679187,"Sommerhausen, M",09,Bayern,1800,860,940,147,94,53,166,105,61,8.2,5.2,2.9,9.2,5.8,3.4
09679206,"Winterhausen, M",09,Bayern,1459,726,733,150,97,53,67,34,33,10.3,6.6,3.6,4.6,2.3,2.3
09679130,Estenfeld,09,Bayern,5060,2488,2572,515,348,167,385,246,139,10.2,6.9,3.3,7.6,4.9,2.7
09679167,"Eisenheim, M",09,Bayern,1323,665,658,113,70,43,51,37,14,8.5,5.3,3.3,3.9,2.8,1.1
09679174,Prosselsheim,09,Bayern,1182,616,566,120,77,43,30,20,10,10.2,6.5,3.6,2.5,1.7,0.8
09679122,"Bütthard, M",09,Bayern,1338,700,638,135,98,37,93,63,30,10.1,7.3,2.8,7.0,4.7,2.2
09679138,"Giebelstadt, M",09,Bayern,5380,2750,2630,586,342,244,947,562,385,10.9,6.4,4.5,17.6,10.4,7.2
09679144,"Helmstadt, M",09,Bayern,2610,1330,1280,323,224,99,167,116,51,12.4,8.6,3.8,6.4,4.4,2.0
09679149,Holzkirchen,09,Bayern,963,482,481,124,80,44,87,53,34,12.9,8.3,4.6,9.0,5.5,3.5
09679177,"Remlingen, M",09,Bayern,1470,738,732,170,111,59,253,166,87,11.6,7.6,4.0,17.2,11.3,5.9
09679196,Uettingen,09,Bayern,1920,996,924,234,152,82,156,84,72,12.2,7.9,4.3,8.1,4.4,3.8
09679137,Geroldshausen,09,Bayern,1278,659,619,148,82,66,63,37,26,11.6,6.4,5.2,4.9,2.9,2.0
09679153,Kirchheim,09,Bayern,2168,1127,1041,218,154,64,106,72,34,10.1,7.1,3.0,4.9,3.3,1.6
09679154,Kist,09,Bayern,2551,1264,1287,262,149,113,169,108,61,10.3,5.8,4.4,6.6,4.2,2.4
09679165,Altertheim,09,Bayern,1945,981,964,189,124,65,53,34,19,9.7,6.4,3.3,2.7,1.7,1.0
09679128,Erlabrunn,09,Bayern,1742,849,893,168,109,59,118,68,50,9.6,6.3,3.4,6.8,3.9,2.9
09679161,Margetshöchheim,09,Bayern,3104,1523,1581,269,169,100,162,105,57,8.7,5.4,3.2,5.2,3.4,1.8
09679118,Bieberehren,09,Bayern,897,453,444,85,67,18,22,16,6,9.5,7.5,2.0,2.5,1.8,0.7
09679179,Riedenheim,09,Bayern,731,392,339,77,49,28,38,22,16,10.5,6.7,3.8,5.2,3.0,2.2
09679182,"Röttingen, St",09,Bayern,1705,841,864,148,104,44,143,107,36,8.7,6.1,2.6,8.4,6.3,2.1
09679192,Tauberrettersheim,09,Bayern,868,435,433,90,68,22,26,17,9,10.4,7.8,2.5,3.0,2.0,1.0
09679141,Greußenheim,09,Bayern,1606,831,775,191,109,82,213,119,94,11.9,6.8,5.1,13.3,7.4,5.9
09679146,Hettstadt,09,Bayern,3642,1822,1820,366,245,121,147,95,52,10.0,6.7,3.3,4.0,2.6,1.4
09761000,Augsburg,09,Bayern,286374,140323,146051,27912,16596,11316,33141,20208,12933,9.7,5.8,4.0,11.6,7.1,4.5
09762000,Kaufbeuren,09,Bayern,42731,20999,21732,4532,2696,1836,4300,2618,1682,10.6,6.3,4.3,10.1,6.1,3.9
09763000,Kempten (Allgäu),09,Bayern,66947,33106,33841,7535,4247,3288,10158,5986,4172,11.3,6.3,4.9,15.2,8.9,6.2
09764000,Memmingen,09,Bayern,42841,21082,21759,4966,2769,2197,6488,3731,2757,11.6,6.5,5.1,15.1,8.7,6.4
09771112,Affing,09,Bayern,5359,2760,2599,606,346,260,482,277,205,11.3,6.5,4.9,9.0,5.2,3.8
09771113,"Aichach, St",09,Bayern,21050,10240,10810,2326,1359,967,2649,1617,1032,11.0,6.5,4.6,12.6,7.7,4.9
09771130,"Friedberg, St",09,Bayern,29339,14349,14990,2954,1825,1129,3246,1958,1288,10.1,6.2,3.8,11.1,6.7,4.4
09771140,Hollenbach,09,Bayern,2402,1268,1134,291,159,132,199,116,83,12.1,6.6,5.5,8.3,4.8,3.5
09771141,"Inchenhofen, M",09,Bayern,2556,1283,1273,310,175,135,162,76,86,12.1,6.8,5.3,6.3,3.0,3.4
09771142,Kissing,09,Bayern,11226,5564,5662,1085,634,451,785,484,301,9.7,5.6,4.0,7.0,4.3,2.7
09771145,Merching,09,Bayern,3132,1571,1561,304,190,114,224,142,82,9.7,6.1,3.6,7.2,4.5,2.6
09771158,Rehling,09,Bayern,2495,1283,1212,262,164,98,369,193,176,10.5,6.6,3.9,14.8,7.7,7.1
09771160,Ried,09,Bayern,3051,1528,1523,332,199,133,291,142,149,10.9,6.5,4.4,9.5,4.7,4.9
09771114,"Aindling, M",09,Bayern,4348,2199,2149,472,308,164,386,237,149,10.9,7.1,3.8,8.9,5.5,3.4
09771155,Petersdorf,09,Bayern,1705,893,812,198,117,81,93,50,43,11.6,6.9,4.8,5.5,2.9,2.5
09771169,Todtenweis,09,Bayern,1355,691,664,181,98,83,103,50,53,13.4,7.2,6.1,7.6,3.7,3.9
09771144,"Kühbach, M",09,Bayern,4230,2142,2088,496,303,193,368,198,170,11.7,7.2,4.6,8.7,4.7,4.0
09771162,Schiltberg,09,Bayern,1950,995,955,234,139,95,98,58,40,12.0,7.1,4.9,5.0,3.0,2.1
09771111,Adelzhausen,09,Bayern,1680,868,812,180,102,78,133,58,75,10.7,6.1,4.6,7.9,3.5,4.5
09771122,Dasing,09,Bayern,5603,2913,2690,650,377,273,802,405,397,11.6,6.7,4.9,14.3,7.2,7.1
09771129,Eurasburg,09,Bayern,1670,852,818,190,120,70,163,93,70,11.4,7.2,4.2,9.8,5.6,4.2
09771149,Obergriesbach,09,Bayern,1986,999,987,228,139,89,123,72,51,11.5,7.0,4.5,6.2,3.6,2.6
09771165,Sielenbach,09,Bayern,1647,846,801,186,110,76,120,60,60,11.3,6.7,4.6,7.3,3.6,3.6
09771146,"Mering, M",09,Bayern,14175,6917,7258,1259,754,505,1087,684,403,8.9,5.3,3.6,7.7,4.8,2.8
09771163,Schmiechen,09,Bayern,1272,638,634,132,86,46,67,42,25,10.4,6.8,3.6,5.3,3.3,2.0
09771168,Steindorf,09,Bayern,933,485,448,127,59,68,73,19,54,13.6,6.3,7.3,7.8,2.0,5.8
09771156,"Pöttmes, M",09,Bayern,6586,3368,3218,764,443,321,715,408,307,11.6,6.7,4.9,10.9,6.2,4.7
09771176,Baar (Schwaben),09,Bayern,1166,589,577,143,90,53,115,72,43,12.3,7.7,4.5,9.9,6.2,3.7
09772111,Adelsried,09,Bayern,2306,1160,1146,249,147,102,168,98,70,10.8,6.4,4.4,7.3,4.2,3.0
09772115,Altenmünster,09,Bayern,3948,1950,1998,396,229,167,224,138,86,10.0,5.8,4.2,5.7,3.5,2.2
09772117,Aystetten,09,Bayern,2993,1456,1537,265,171,94,220,137,83,8.9,5.7,3.1,7.4,4.6,2.8
09772121,"Biberbach, M",09,Bayern,3444,1718,1726,385,233,152,165,100,65,11.2,6.8,4.4,4.8,2.9,1.9
09772125,"Bobingen, St",09,Bayern,16955,8426,8529,1633,998,635,1392,811,581,9.6,5.9,3.7,8.2,4.8,3.4
09772130,"Diedorf, M",09,Bayern,9995,4884,5111,914,525,389,734,420,314,9.1,5.3,3.9,7.3,4.2,3.1
09772131,"Dinkelscherben, M",09,Bayern,6517,3302,3215,682,426,256,433,290,143,10.5,6.5,3.9,6.6,4.4,2.2
09772141,"Fischach, M",09,Bayern,4629,2320,2309,522,308,214,498,324,174,11.3,6.7,4.6,10.8,7.0,3.8
09772145,Gablingen,09,Bayern,4492,2291,2201,481,286,195,271,180,91,10.7,6.4,4.3,6.0,4.0,2.0
09772147,"Gersthofen, St",09,Bayern,21908,10816,11092,2244,1225,1019,3327,1769,1558,10.2,5.6,4.7,15.2,8.1,7.1
09772149,Graben,09,Bayern,3863,1940,1923,343,199,144,181,99,82,8.9,5.2,3.7,4.7,2.6,2.1
09772159,Horgau,09,Bayern,2594,1334,1260,255,166,89,175,122,53,9.8,6.4,3.4,6.7,4.7,2.0
09772163,"Königsbrunn, St",09,Bayern,27772,13764,14008,2738,1593,1145,2420,1412,1008,9.9,5.7,4.1,8.7,5.1,3.6
09772167,Kutzenhausen,09,Bayern,2482,1242,1240,248,152,96,120,57,63,10.0,6.1,3.9,4.8,2.3,2.5
09772171,Langweid a.Lech,09,Bayern,7962,4031,3931,820,479,341,695,413,282,10.3,6.0,4.3,8.7,5.2,3.5
09772177,"Meitingen, M",09,Bayern,11290,5636,5654,1146,637,509,1000,552,448,10.2,5.6,4.5,8.9,4.9,4.0
09772184,"Neusäß, St",09,Bayern,21617,10309,11308,1957,1170,787,2982,1704,1278,9.1,5.4,3.6,13.8,7.9,5.9
09772200,"Schwabmünchen, St",09,Bayern,13836,6861,6975,1377,827,550,1331,824,507,10.0,6.0,4.0,9.6,6.0,3.7
09772202,"Stadtbergen, St",09,Bayern,14749,7158,7591,1335,777,558,1475,884,591,9.1,5.3,3.8,10.0,6.0,4.0
09772207,"Thierhaupten, M",09,Bayern,3991,2015,1976,429,284,145,401,246,155,10.7,7.1,3.6,10.0,6.2,3.9
09772215,Wehringen,09,Bayern,2860,1439,1421,278,163,115,233,151,82,9.7,5.7,4.0,8.1,5.3,2.9
09772223,"Zusmarshausen, M",09,Bayern,6255,3171,3084,592,355,237,568,331,237,9.5,5.7,3.8,9.1,5.3,3.8
09772114,Allmannshofen,09,Bayern,854,460,394,81,46,35,56,31,25,9.5,5.4,4.1,6.6,3.6,2.9
09772134,Ehingen,09,Bayern,991,507,484,92,55,37,39,22,17,9.3,5.5,3.7,3.9,2.2,1.7
09772136,Ellgau,09,Bayern,1065,543,522,110,65,45,90,55,35,10.3,6.1,4.2,8.5,5.2,3.3
09772166,Kühlenthal,09,Bayern,814,413,401,79,55,24,56,21,35,9.7,6.8,2.9,6.9,2.6,4.3
09772185,Nordendorf,09,Bayern,2312,1180,1132,213,116,97,162,110,52,9.2,5.0,4.2,7.0,4.8,2.2
09772217,Westendorf,09,Bayern,1529,764,765,170,93,77,209,118,91,11.1,6.1,5.0,13.7,7.7,6.0
09772126,Bonstetten,09,Bayern,1331,662,669,122,84,38,54,37,17,9.2,6.3,2.9,4.1,2.8,1.3
09772137,Emersacker,09,Bayern,1357,697,660,144,82,62,142,65,77,10.6,6.0,4.6,10.5,4.8,5.7
09772156,Heretsried,09,Bayern,959,493,466,89,60,29,19,14,5,9.3,6.3,3.0,2.0,1.5,0.5
09772216,"Welden, M",09,Bayern,3670,1831,1839,333,189,144,283,177,106,9.1,5.1,3.9,7.7,4.8,2.9
09772148,Gessertshausen,09,Bayern,4173,2067,2106,373,223,150,252,142,110,8.9,5.3,3.6,6.0,3.4,2.6
09772211,Ustersbach,09,Bayern,1102,542,560,96,64,32,68,40,28,8.7,5.8,2.9,6.2,3.6,2.5
09772168,Langenneufnach,09,Bayern,1713,861,852,143,86,57,134,77,57,8.3,5.0,3.3,7.8,4.5,3.3
09772178,Mickhausen,09,Bayern,1396,709,687,159,101,58,195,96,99,11.4,7.2,4.2,14.0,6.9,7.1
09772179,Mittelneufnach,09,Bayern,1094,571,523,97,61,36,77,45,32,8.9,5.6,3.3,7.0,4.1,2.9
09772197,Scherstetten,09,Bayern,1015,520,495,118,71,47,58,37,21,11.6,7.0,4.6,5.7,3.6,2.1
09772214,Walkertshofen,09,Bayern,1142,592,550,125,72,53,72,40,32,10.9,6.3,4.6,6.3,3.5,2.8
09772151,Großaitingen,09,Bayern,4986,2513,2473,529,341,188,404,254,150,10.6,6.8,3.8,8.1,5.1,3.0
09772160,Kleinaitingen,09,Bayern,1230,637,593,115,64,51,45,23,22,9.3,5.2,4.1,3.7,1.9,1.8
09772186,Oberottmarshausen,09,Bayern,1717,857,860,168,102,66,87,55,32,9.8,5.9,3.8,5.1,3.2,1.9
09772162,Klosterlechfeld,09,Bayern,2867,1442,1425,254,153,101,118,77,41,8.9,5.3,3.5,4.1,2.7,1.4
09772209,Untermeitingen,09,Bayern,6686,3308,3378,649,375,274,553,328,225,9.7,5.6,4.1,8.3,4.9,3.4
09772157,Hiltenfingen,09,Bayern,1456,742,714,149,97,52,73,39,34,10.2,6.7,3.6,5.0,2.7,2.3
09772170,Langerringen,09,Bayern,3683,1896,1787,368,235,133,239,145,94,10.0,6.4,3.6,6.5,3.9,2.6
09773117,"Bissingen, M",09,Bayern,3595,1811,1784,388,224,164,270,147,123,10.8,6.2,4.6,7.5,4.1,3.4
09773122,Buttenwiesen,09,Bayern,5776,2987,2789,633,364,269,573,317,256,11.0,6.3,4.7,9.9,5.5,4.4
09773125,"Dillingen a.d.Donau, GKSt",09,Bayern,18547,9111,9436,1963,1083,880,2128,1246,882,10.6,5.8,4.7,11.5,6.7,4.8
09773144,"Lauingen (Donau), St",09,Bayern,10773,5306,5467,1113,622,491,1049,600,449,10.3,5.8,4.6,9.7,5.6,4.2
09773113,Bächingen a.d.Brenz,09,Bayern,1302,663,639,119,57,62,91,45,46,9.1,4.4,4.8,7.0,3.5,3.5
09773136,"Gundelfingen a.d.Donau, St",09,Bayern,7812,3887,3925,864,474,390,946,512,434,11.1,6.1,5.0,12.1,6.6,5.6
09773137,Haunsheim,09,Bayern,1591,801,790,134,68,66,78,37,41,8.4,4.3,4.1,4.9,2.3,2.6
09773153,Medlingen,09,Bayern,1042,536,506,85,51,34,30,18,12,8.2,4.9,3.3,2.9,1.7,1.2
09773112,Bachhagel,09,Bayern,2174,1083,1091,240,144,96,190,130,60,11.0,6.6,4.4,8.7,6.0,2.8
09773170,Syrgenstein,09,Bayern,3658,1804,1854,320,195,125,211,128,83,8.7,5.3,3.4,5.8,3.5,2.3
09773187,Zöschingen,09,Bayern,737,358,379,84,65,19,66,49,17,11.4,8.8,2.6,9.0,6.6,2.3
09773147,Mödingen,09,Bayern,1290,636,654,137,77,60,110,59,51,10.6,6.0,4.7,8.5,4.6,4.0
09773183,"Wittislingen, M",09,Bayern,2354,1179,1175,196,122,74,157,98,59,8.3,5.2,3.1,6.7,4.2,2.5
09773186,Ziertheim,09,Bayern,985,487,498,111,74,37,177,94,83,11.3,7.5,3.8,18.0,9.5,8.4
09773119,Blindheim,09,Bayern,1669,856,813,186,114,72,98,55,43,11.1,6.8,4.3,5.9,3.3,2.6
09773139,"Höchstädt a.d.Donau, St",09,Bayern,6663,3314,3349,690,401,289,578,325,253,10.4,6.0,4.3,8.7,4.9,3.8
09773146,Lutzingen,09,Bayern,1005,498,507,106,68,38,97,47,50,10.5,6.8,3.8,9.7,4.7,5.0
09773150,Finningen,09,Bayern,1677,868,809,201,110,91,124,63,61,12.0,6.6,5.4,7.4,3.8,3.6
09773164,Schwenningen,09,Bayern,1448,742,706,154,75,79,88,50,38,10.6,5.2,5.5,6.1,3.5,2.6
09773116,Binswangen,09,Bayern,1308,680,628,151,87,64,59,34,25,11.5,6.7,4.9,4.5,2.6,1.9
09773143,Laugna,09,Bayern,1577,833,744,203,120,83,88,44,44,12.9,7.6,5.3,5.6,2.8,2.8
09773179,Villenbach,09,Bayern,1269,650,619,123,87,36,56,35,21,9.7,6.9,2.8,4.4,2.8,1.7
09773182,"Wertingen, St",09,Bayern,9015,4466,4549,1035,636,399,1376,863,513,11.5,7.1,4.4,15.3,9.6,5.7
09773188,Zusamaltheim,09,Bayern,1208,625,583,144,78,66,122,51,71,11.9,6.5,5.5,10.1,4.2,5.9
09773111,"Aislingen, M",09,Bayern,1307,656,651,156,100,56,96,54,42,11.9,7.7,4.3,7.3,4.1,3.2
09773133,Glött,09,Bayern,1101,551,550,111,64,47,27,16,11,10.1,5.8,4.3,2.5,1.5,1.0
09773140,Holzheim,09,Bayern,3692,1842,1850,359,220,139,207,130,77,9.7,6.0,3.8,5.6,3.5,2.1
09774116,Ursberg,09,Bayern,3175,1627,1548,217,119,98,302,181,121,6.8,3.7,3.1,9.5,5.7,3.8
09774119,Bibertal,09,Bayern,4762,2412,2350,554,341,213,315,189,126,11.6,7.2,4.5,6.6,4.0,2.6
09774121,"Burgau, St",09,Bayern,9579,4776,4803,1080,603,477,1136,660,476,11.3,6.3,5.0,11.9,6.9,5.0
09774122,"Burtenbach, M",09,Bayern,3361,1722,1639,411,236,175,239,134,105,12.2,7.0,5.2,7.1,4.0,3.1
09774135,"Günzburg, GKSt",09,Bayern,20038,9794,10244,2098,1123,975,2909,1649,1260,10.5,5.6,4.9,14.5,8.2,6.3
09774144,"Jettingen-Scheppach, M",09,Bayern,6945,3502,3443,713,433,280,696,433,263,10.3,6.2,4.0,10.0,6.2,3.8
09774145,Kammeltal,09,Bayern,3289,1653,1636,388,223,165,267,149,118,11.8,6.8,5.0,8.1,4.5,3.6
09774150,"Krumbach (Schwaben), St",09,Bayern,12891,6346,6545,1430,773,657,1738,980,758,11.1,6.0,5.1,13.5,7.6,5.9
09774155,"Leipheim, St",09,Bayern,6926,3595,3331,717,391,326,687,353,334,10.4,5.6,4.7,9.9,5.1,4.8
09774162,"Neuburg a.d.Kammel, M",09,Bayern,3203,1649,1554,385,215,170,272,169,103,12.0,6.7,5.3,8.5,5.3,3.2
09774136,Gundremmingen,09,Bayern,1447,797,650,143,85,58,98,52,46,9.9,5.9,4.0,6.8,3.6,3.2
09774171,"Offingen, M",09,Bayern,4279,2200,2079,493,260,233,433,227,206,11.5,6.1,5.4,10.1,5.3,4.8
09774174,Rettenbach,09,Bayern,1655,832,823,174,105,69,-1,-1,-1,10.5,6.3,4.2,-0.1,,
09774127,Dürrlauingen,09,Bayern,1646,911,735,130,81,49,71,46,25,7.9,4.9,3.0,4.3,2.8,1.5
09774140,Haldenwang,09,Bayern,1886,945,941,213,131,82,122,69,53,11.3,6.9,4.3,6.5,3.7,2.8
09774151,Landensberg,09,Bayern,708,366,342,66,34,32,-1,-1,-1,9.3,4.8,4.5,-0.1,,
09774178,Röfingen,09,Bayern,1090,562,528,132,80,52,94,58,36,12.1,7.3,4.8,8.6,5.3,3.3
09774196,Winterbach,09,Bayern,759,374,385,99,51,48,53,30,23,13.0,6.7,6.3,7.0,4.0,3.0
09774118,Bubesheim,09,Bayern,1575,799,776,178,100,78,114,57,57,11.3,6.3,5.0,7.2,3.6,3.6
09774148,Kötz,09,Bayern,3275,1677,1598,367,192,175,231,116,115,11.2,5.9,5.3,7.1,3.5,3.5
09774133,Ellzee,09,Bayern,1183,601,582,137,73,64,60,29,31,11.6,6.2,5.4,5.1,2.5,2.6
09774143,"Ichenhausen, St",09,Bayern,8759,4458,4301,885,509,376,677,365,312,10.1,5.8,4.3,7.7,4.2,3.6
09774191,"Waldstetten, M",09,Bayern,1235,647,588,193,107,86,117,62,55,15.6,8.7,7.0,9.5,5.0,4.5
09774111,Aletshausen,09,Bayern,1127,597,530,144,81,63,101,37,64,12.8,7.2,5.6,9.0,3.3,5.7
09774117,Breitenthal,09,Bayern,1220,605,615,159,98,61,109,60,49,13.0,8.0,5.0,8.9,4.9,4.0
09774124,Deisenhausen,09,Bayern,1476,743,733,184,102,82,192,84,108,12.5,6.9,5.6,13.0,5.7,7.3
09774129,Ebershausen,09,Bayern,608,318,290,87,54,33,70,27,43,14.3,8.9,5.4,11.5,4.4,7.1
09774189,Wiesenbach,09,Bayern,963,488,475,131,67,64,70,31,39,13.6,7.0,6.6,7.3,3.2,4.0
09774192,Waltenhausen,09,Bayern,702,363,339,96,49,47,45,24,21,13.7,7.0,6.7,6.4,3.4,3.0
09774115,Balzhausen,09,Bayern,1234,648,586,125,67,58,101,47,54,10.1,5.4,4.7,8.2,3.8,4.4
09774160,"Münsterhausen, M",09,Bayern,1979,1028,951,226,122,104,74,43,31,11.4,6.2,5.3,3.7,2.2,1.6
09774185,"Thannhausen, St",09,Bayern,6095,2970,3125,718,405,313,752,450,302,11.8,6.6,5.1,12.3,7.4,5.0
09774166,Aichen,09,Bayern,1130,575,555,128,67,61,86,28,58,11.3,5.9,5.4,7.6,2.5,5.1
09774198,"Ziemetshausen, M",09,Bayern,2953,1493,1460,322,201,121,270,155,115,10.9,6.8,4.1,9.1,5.2,3.9
09775115,Bellenberg,09,Bayern,4423,2155,2268,521,329,192,387,231,156,11.8,7.4,4.3,8.7,5.2,3.5
09775129,"Illertissen, St",09,Bayern,16904,8237,8667,1855,1137,718,1937,1202,735,11.0,6.7,4.2,11.5,7.1,4.3
09775134,Nersingen,09,Bayern,9288,4684,4604,1143,697,446,624,383,241,12.3,7.5,4.8,6.7,4.1,2.6
09775135,"Neu-Ulm, GKSt",09,Bayern,57237,28471,28766,6514,3651,2863,6738,3849,2889,11.4,6.4,5.0,11.8,6.7,5.0
09775139,Elchingen,09,Bayern,9261,4567,4694,1025,625,400,791,490,301,11.1,6.7,4.3,8.5,5.3,3.3
09775149,Roggenburg,09,Bayern,2673,1334,1339,368,222,146,252,160,92,13.8,8.3,5.5,9.4,6.0,3.4
09775152,"Senden, St",09,Bayern,21909,10697,11212,2600,1492,1108,1902,1124,778,11.9,6.8,5.1,8.7,5.1,3.6
09775162,"Vöhringen, St",09,Bayern,13198,6478,6720,1387,822,565,1056,655,401,10.5,6.2,4.3,8.0,5.0,3.0
09775164,"Weißenhorn, St",09,Bayern,13329,6699,6630,1612,965,647,1506,846,660,12.1,7.2,4.9,11.3,6.3,5.0
09775126,Holzheim,09,Bayern,1852,940,912,219,125,94,105,49,56,11.8,6.7,5.1,5.7,2.6,3.0
09775143,"Pfaffenhofen a.d.Roth, M",09,Bayern,7171,3673,3498,813,505,308,501,322,179,11.3,7.0,4.3,7.0,4.5,2.5
09775111,"Altenstadt, M",09,Bayern,5024,2578,2446,618,387,231,640,367,273,12.3,7.7,4.6,12.7,7.3,5.4
09775132,"Kellmünz a.d.Iller, M",09,Bayern,1378,696,682,176,111,65,91,47,44,12.8,8.1,4.7,6.6,3.4,3.2
09775142,Osterberg,09,Bayern,881,437,444,111,72,39,47,23,24,12.6,8.2,4.4,5.3,2.6,2.7
09775118,"Buch, M",09,Bayern,3856,1955,1901,458,287,171,367,185,182,11.9,7.4,4.4,9.5,4.8,4.7
09775141,Oberroth,09,Bayern,900,465,435,135,80,55,50,22,28,15.0,8.9,6.1,5.6,2.4,3.1
09775161,Unterroth,09,Bayern,1025,540,485,129,77,52,74,45,29,12.6,7.5,5.1,7.2,4.4,2.8
09776111,Bodolz,09,Bayern,2984,1447,1537,272,169,103,147,85,62,9.1,5.7,3.5,4.9,2.8,2.1
09776114,"Heimenkirch, M",09,Bayern,3603,1816,1787,438,253,185,285,160,125,12.2,7.0,5.1,7.9,4.4,3.5
09776116,"Lindau (Bodensee), GKSt",09,Bayern,25132,12007,13125,2837,1773,1064,2998,1888,1110,11.3,7.1,4.2,11.9,7.5,4.4
09776117,"Lindenberg i.Allgäu, St",09,Bayern,11295,5551,5744,1381,743,638,1311,743,568,12.2,6.6,5.6,11.6,6.6,5.0
09776120,Nonnenhorn,09,Bayern,1726,828,898,183,119,64,164,94,70,10.6,6.9,3.7,9.5,5.4,4.1
09776122,Opfenbach,09,Bayern,2278,1153,1125,281,176,105,172,104,68,12.3,7.7,4.6,7.6,4.6,3.0
09776125,"Scheidegg, M",09,Bayern,4226,2040,2186,479,275,204,450,261,189,11.3,6.5,4.8,10.6,6.2,4.5
09776128,Wasserburg (Bodensee),09,Bayern,3616,1730,1886,365,260,105,336,213,123,10.1,7.2,2.9,9.3,5.9,3.4
09776129,"Weiler-Simmerberg, M",09,Bayern,6145,3117,3028,787,441,346,695,394,301,12.8,7.2,5.6,11.3,6.4,4.9
09776131,Hergatz,09,Bayern,2393,1215,1178,256,168,88,128,75,53,10.7,7.0,3.7,5.3,3.1,2.2
09776115,Hergensweiler,09,Bayern,1860,947,913,233,154,79,152,81,71,12.5,8.3,4.2,8.2,4.4,3.8
09776126,Sigmarszell,09,Bayern,2900,1460,1440,331,199,132,195,108,87,11.4,6.9,4.6,6.7,3.7,3.0
09776130,Weißensberg,09,Bayern,2681,1355,1326,291,167,124,238,131,107,10.9,6.2,4.6,8.9,4.9,4.0
09776112,Gestratz,09,Bayern,1270,661,609,167,94,73,88,37,51,13.1,7.4,5.7,6.9,2.9,4.0
09776113,Grünenbach,09,Bayern,1503,764,739,183,106,77,126,73,53,12.2,7.1,5.1,8.4,4.9,3.5
09776118,Maierhöfen,09,Bayern,1571,823,748,172,104,68,154,97,57,10.9,6.6,4.3,9.8,6.2,3.6
09776124,Röthenbach (Allgäu),09,Bayern,1769,911,858,237,130,107,174,101,73,13.4,7.3,6.0,9.8,5.7,4.1
09776121,Oberreute,09,Bayern,1635,825,810,177,108,69,100,58,42,10.8,6.6,4.2,6.1,3.5,2.6
09776127,Stiefenhofen,09,Bayern,1842,900,942,263,155,108,133,83,50,14.3,8.4,5.9,7.2,4.5,2.7
09777129,"Füssen, St",09,Bayern,15265,7342,7923,1768,954,814,2056,1217,839,11.6,6.2,5.3,13.5,8.0,5.5
09777130,Germaringen,09,Bayern,3801,1909,1892,437,250,187,292,173,119,11.5,6.6,4.9,7.7,4.6,3.1
09777147,Lechbruck am See,09,Bayern,2732,1359,1373,293,187,106,281,185,96,10.7,6.8,3.9,10.3,6.8,3.5
09777151,"Marktoberdorf, St",09,Bayern,18349,9135,9214,1779,1105,674,1840,1167,673,9.7,6.0,3.7,10.0,6.4,3.7
09777152,Mauerstetten,09,Bayern,3113,1559,1554,330,203,127,346,216,130,10.6,6.5,4.1,11.1,6.9,4.2
09777153,"Nesselwang, M",09,Bayern,3541,1717,1824,474,263,211,517,275,242,13.4,7.4,6.0,14.6,7.8,6.8
09777159,Pfronten,09,Bayern,8221,4048,4173,959,582,377,858,535,323,11.7,7.1,4.6,10.4,6.5,3.9
09777165,"Ronsberg, M",09,Bayern,1708,886,822,153,97,56,133,84,49,9.0,5.7,3.3,7.8,4.9,2.9
09777169,Schwangau,09,Bayern,3233,1583,1650,363,203,160,519,265,254,11.2,6.3,4.9,16.1,8.2,7.9
09777173,Halblech,09,Bayern,3477,1738,1739,401,260,141,271,159,112,11.5,7.5,4.1,7.8,4.6,3.2
09777121,"Buchloe, St",09,Bayern,12568,6174,6394,1293,753,540,1044,625,419,10.3,6.0,4.3,8.3,5.0,3.3
09777140,Jengen,09,Bayern,2405,1205,1200,250,138,112,156,75,81,10.4,5.7,4.7,6.5,3.1,3.4
09777145,Lamerdingen,09,Bayern,1919,955,964,204,128,76,153,91,62,10.6,6.7,4.0,8.0,4.7,3.2
09777177,"Waal, M",09,Bayern,2250,1144,1106,230,142,88,153,84,69,10.2,6.3,3.9,6.8,3.7,3.1
09777139,"Irsee, M",09,Bayern,1481,716,765,128,82,46,122,71,51,8.6,5.5,3.1,8.2,4.8,3.4
09777158,Pforzen,09,Bayern,2216,1120,1096,242,145,97,173,99,74,10.9,6.5,4.4,7.8,4.5,3.3
09777164,Rieden,09,Bayern,1305,633,672,158,94,64,86,54,32,12.1,7.2,4.9,6.6,4.1,2.5
09777141,"Kaltental, M",09,Bayern,1653,865,788,192,114,78,175,84,91,11.6,6.9,4.7,10.6,5.1,5.5
09777155,Oberostendorf,09,Bayern,1372,696,676,150,75,75,175,130,45,10.9,5.5,5.5,12.8,9.5,3.3
09777157,Osterzell,09,Bayern,682,356,326,69,41,28,42,20,22,10.1,6.0,4.1,6.2,2.9,3.2
09777172,Stöttwang,09,Bayern,1782,867,915,211,133,78,125,79,46,11.8,7.5,4.4,7.0,4.4,2.6
09777182,Westendorf,09,Bayern,1853,943,910,255,155,100,247,105,142,13.8,8.4,5.4,13.3,5.7,7.7
09777111,Aitrang,09,Bayern,2033,1025,1008,209,140,69,167,109,58,10.3,6.9,3.4,8.2,5.4,2.9
09777112,Biessenhofen,09,Bayern,4061,2062,1999,395,246,149,344,202,142,9.7,6.1,3.7,8.5,5.0,3.5
09777118,Bidingen,09,Bayern,1644,859,785,164,104,60,85,55,30,10.0,6.3,3.6,5.2,3.3,1.8
09777167,Ruderatshofen,09,Bayern,1825,961,864,197,122,75,168,98,70,10.8,6.7,4.1,9.2,5.4,3.8
09777114,Baisweil,09,Bayern,1289,651,638,140,88,52,62,42,20,10.9,6.8,4.0,4.8,3.3,1.6
09777124,Eggenthal,09,Bayern,1341,712,629,134,91,43,75,51,24,10.0,6.8,3.2,5.6,3.8,1.8
09777128,Friesenried,09,Bayern,1533,768,765,171,100,71,96,59,37,11.2,6.5,4.6,6.3,3.8,2.4
09777138,Günzach,09,Bayern,1440,723,717,173,108,65,93,57,36,12.0,7.5,4.5,6.5,4.0,2.5
09777154,"Obergünzburg, M",09,Bayern,6295,3168,3127,627,387,240,501,329,172,10.0,6.1,3.8,8.0,5.2,2.7
09777176,Untrasried,09,Bayern,1570,817,753,184,102,82,106,63,43,11.7,6.5,5.2,6.8,4.0,2.7
09777131,Görisried,09,Bayern,1340,673,667,131,71,60,105,67,38,9.8,5.3,4.5,7.8,5.0,2.8
09777144,Kraftisried,09,Bayern,764,390,374,114,78,36,52,39,13,14.9,10.2,4.7,6.8,5.1,1.7
09777175,"Unterthingau, M",09,Bayern,2789,1429,1360,305,188,117,247,133,114,10.9,6.7,4.2,8.9,4.8,4.1
09777125,Eisenberg,09,Bayern,1189,612,577,143,105,38,116,80,36,12.0,8.8,3.2,9.8,6.7,3.0
09777135,Hopferau,09,Bayern,1126,569,557,141,93,48,106,63,43,12.5,8.3,4.3,9.4,5.6,3.8
09777149,Lengenwang,09,Bayern,1439,752,687,157,93,64,98,63,35,10.9,6.5,4.4,6.8,4.4,2.4
09777168,Rückholz,09,Bayern,845,440,405,109,68,41,104,61,43,12.9,8.0,4.9,12.3,7.2,5.1
09777170,Seeg,09,Bayern,2923,1470,1453,359,197,162,244,152,92,12.3,6.7,5.5,8.3,5.2,3.1
09777179,Wald,09,Bayern,1166,618,548,127,84,43,77,46,31,10.9,7.2,3.7,6.6,3.9,2.7
09777163,Rieden am Forggensee,09,Bayern,1269,631,638,166,106,60,115,62,53,13.1,8.4,4.7,9.1,4.9,4.2
09777166,Roßhaupten,09,Bayern,2209,1089,1120,241,141,100,171,97,74,10.9,6.4,4.5,7.7,4.4,3.3
09777171,Stötten a.Auerberg,09,Bayern,1866,946,920,206,131,75,132,72,60,11.0,7.0,4.0,7.1,3.9,3.2
09777183,Rettenbach a.Auerberg,09,Bayern,827,435,392,97,69,28,96,66,30,11.7,8.3,3.4,11.6,8.0,3.6
09778116,"Bad Wörishofen, St",09,Bayern,15446,7267,8179,1503,872,631,1776,1103,673,9.7,5.6,4.1,11.5,7.1,4.4
09778123,Buxheim,09,Bayern,3138,1596,1542,310,183,127,151,101,50,9.9,5.8,4.0,4.8,3.2,1.6
09778137,Ettringen,09,Bayern,3380,1751,1629,384,247,137,323,195,128,11.4,7.3,4.1,9.6,5.8,3.8
09778168,"Markt Rettenbach, M",09,Bayern,3777,1909,1868,431,270,161,277,174,103,11.4,7.1,4.3,7.3,4.6,2.7
09778169,"Markt Wald, M",09,Bayern,2206,1154,1052,246,152,94,126,82,44,11.2,6.9,4.3,5.7,3.7,2.0
09778173,"Mindelheim, St",09,Bayern,14569,7247,7322,1658,998,660,2211,1424,787,11.4,6.9,4.5,15.2,9.8,5.4
09778196,Sontheim,09,Bayern,2564,1304,1260,291,172,119,162,92,70,11.3,6.7,4.6,6.3,3.6,2.7
09778204,"Tussenhausen, M",09,Bayern,2975,1554,1421,299,204,95,160,100,60,10.1,6.9,3.2,5.4,3.4,2.0
09778119,Böhen,09,Bayern,741,409,332,76,47,29,-1,-1,-1,10.3,6.3,3.9,-0.1,,
09778149,Hawangen,09,Bayern,1350,695,655,152,89,63,100,60,40,11.3,6.6,4.7,7.4,4.4,3.0
09778186,"Ottobeuren, M",09,Bayern,8170,4062,4108,942,539,403,853,520,333,11.5,6.6,4.9,10.4,6.4,4.1
09778115,"Babenhausen, M",09,Bayern,5488,2760,2728,645,397,248,924,648,276,11.8,7.2,4.5,16.8,11.8,5.0
09778130,Egg a.d.Günz,09,Bayern,1208,635,573,153,85,68,57,29,28,12.7,7.0,5.6,4.7,2.4,2.3
09778157,Kirchhaslach,09,Bayern,1282,668,614,147,94,53,67,41,26,11.5,7.3,4.1,5.2,3.2,2.0
09778184,Oberschönegg,09,Bayern,962,512,450,105,61,44,-1,-1,-1,10.9,6.3,4.6,-0.1,,
09778217,Winterrieden,09,Bayern,928,494,434,113,63,50,82,41,41,12.2,6.8,5.4,8.8,4.4,4.4
09778221,Kettershausen,09,Bayern,1745,909,836,209,138,71,99,52,47,12.0,7.9,4.1,5.7,3.0,2.7
09778121,Breitenbrunn,09,Bayern,2314,1170,1144,250,159,91,151,93,58,10.8,6.9,3.9,6.5,4.0,2.5
09778183,Oberrieden,09,Bayern,1237,660,577,136,107,29,43,28,15,11.0,8.6,2.3,3.5,2.3,1.2
09778187,"Pfaffenhausen, M",09,Bayern,2525,1298,1227,253,170,83,266,188,78,10.0,6.7,3.3,10.5,7.4,3.1
09778190,Salgen,09,Bayern,1448,752,696,152,99,53,111,51,60,10.5,6.8,3.7,7.7,3.5,4.1
09778134,Eppishausen,09,Bayern,1838,948,890,212,129,83,94,47,47,11.5,7.0,4.5,5.1,2.6,2.6
09778158,"Kirchheim i.Schw., M",09,Bayern,2597,1335,1262,259,149,110,226,130,96,10.0,5.7,4.2,8.7,5.0,3.7
09778120,Boos,09,Bayern,1962,968,994,216,143,73,126,86,40,11.0,7.3,3.7,6.4,4.4,2.0
09778139,Fellheim,09,Bayern,1119,552,567,149,87,62,119,70,49,13.3,7.8,5.5,10.6,6.3,4.4
09778150,Heimertingen,09,Bayern,1721,855,866,260,150,110,230,112,118,15.1,8.7,6.4,13.4,6.5,6.9
09778177,Niederrieden,09,Bayern,1394,722,672,186,118,68,78,47,31,13.3,8.5,4.9,5.6,3.4,2.2
09778188,Pleß,09,Bayern,838,447,391,125,74,51,77,39,38,14.9,8.8,6.1,9.2,4.7,4.5
09778136,"Erkheim, M",09,Bayern,2970,1503,1467,378,232,146,465,312,153,12.7,7.8,4.9,15.7,10.5,5.2
09778163,Lauben,09,Bayern,1376,696,680,186,111,75,84,50,34,13.5,8.1,5.5,6.1,3.6,2.5
09778180,Kammlach,09,Bayern,1801,940,861,204,118,86,130,86,44,11.3,6.6,4.8,7.2,4.8,2.4
09778214,Westerheim,09,Bayern,2182,1130,1052,310,199,111,321,163,158,14.2,9.1,5.1,14.7,7.5,7.2
09778111,Amberg,09,Bayern,1421,710,711,169,107,62,55,31,24,11.9,7.5,4.4,3.9,2.2,1.7
09778203,"Türkheim, M",09,Bayern,6998,3556,3442,791,459,332,615,372,243,11.3,6.6,4.7,8.8,5.3,3.5
09778209,Rammingen,09,Bayern,1527,794,733,160,94,66,102,57,45,10.5,6.2,4.3,6.7,3.7,2.9
09778216,Wiedergeltingen,09,Bayern,1368,695,673,146,88,58,109,49,60,10.7,6.4,4.2,8.0,3.6,4.4
09778118,Benningen,09,Bayern,2058,1008,1050,270,147,123,191,115,76,13.1,7.1,6.0,9.3,5.6,3.7
09778151,Holzgünz,09,Bayern,1267,629,638,166,96,70,101,61,40,13.1,7.6,5.5,8.0,4.8,3.2
09778162,Lachen,09,Bayern,1472,743,729,165,91,74,71,42,29,11.2,6.2,5.0,4.8,2.9,2.0
09778171,Memmingerberg,09,Bayern,2825,1433,1392,330,167,163,292,136,156,11.7,5.9,5.8,10.3,4.8,5.5
09778202,Trunkelsberg,09,Bayern,1683,819,864,173,106,67,68,35,33,10.3,6.3,4.0,4.0,2.1,2.0
09778205,Ungerhausen,09,Bayern,1079,545,534,149,88,61,154,92,62,13.8,8.2,5.7,14.3,8.5,5.7
09778113,Apfeltrach,09,Bayern,919,463,456,115,70,45,56,21,35,12.5,7.6,4.9,6.1,2.3,3.8
09778127,"Dirlewang, M",09,Bayern,2126,1079,1047,243,156,87,169,119,50,11.4,7.3,4.1,7.9,5.6,2.4
09778199,Stetten,09,Bayern,1401,706,695,168,107,61,116,65,51,12.0,7.6,4.4,8.3,4.6,3.6
09778207,Unteregg,09,Bayern,1361,693,668,148,109,39,96,61,35,10.9,8.0,2.9,7.1,4.5,2.6
09778161,Kronburg,09,Bayern,1755,866,889,240,147,93,198,113,85,13.7,8.4,5.3,11.3,6.4,4.8
09778164,Lautrach,09,Bayern,1247,608,639,125,78,47,127,82,45,10.0,6.3,3.8,10.2,6.6,3.6
09778165,"Legau, M",09,Bayern,3207,1639,1568,383,239,144,351,223,128,11.9,7.5,4.5,10.9,7.0,4.0
09778144,"Bad Grönenbach, M",09,Bayern,5528,2730,2798,638,367,271,635,332,303,11.5,6.6,4.9,11.5,6.0,5.5
09778218,Wolfertschwenden,09,Bayern,1960,977,983,197,117,80,210,129,81,10.1,6.0,4.1,10.7,6.6,4.1
09778219,Woringen,09,Bayern,1966,977,989,231,127,104,222,115,107,11.7,6.5,5.3,11.3,5.8,5.4
09779115,Asbach-Bäumenheim,09,Bayern,4587,2383,2204,500,275,225,431,271,160,10.9,6.0,4.9,9.4,5.9,3.5
09779131,"Donauwörth, GKSt",09,Bayern,18972,9337,9635,2028,1216,812,2972,1777,1195,10.7,6.4,4.3,15.7,9.4,6.3
09779147,Fremdingen,09,Bayern,2079,1024,1055,300,189,111,178,120,58,14.4,9.1,5.3,8.6,5.8,2.8
09779155,"Harburg (Schwaben), St",09,Bayern,5463,2763,2700,596,361,235,427,246,181,10.9,6.6,4.3,7.8,4.5,3.3
09779169,"Kaisheim, M",09,Bayern,3833,2173,1660,373,258,115,257,151,106,9.7,6.7,3.0,6.7,3.9,2.8
09779178,Marxheim,09,Bayern,2562,1363,1199,209,119,90,135,68,67,8.2,4.6,3.5,5.3,2.7,2.6
09779181,Mertingen,09,Bayern,3979,2017,1962,384,194,190,329,176,153,9.7,4.9,4.8,8.3,4.4,3.8
09779185,Möttingen,09,Bayern,2474,1269,1205,296,163,133,225,115,110,12.0,6.6,5.4,9.1,4.6,4.4
09779194,"Nördlingen, GKSt",09,Bayern,19841,9740,10101,2308,1306,1002,3055,1794,1261,11.6,6.6,5.1,15.4,9.0,6.4
09779196,Oberndorf a.Lech,09,Bayern,2442,1232,1210,235,142,93,172,98,74,9.6,5.8,3.8,7.0,4.0,3.0
09779218,Tapfheim,09,Bayern,3910,1952,1958,410,245,165,378,235,143,10.5,6.3,4.2,9.7,6.0,3.7
09779176,Maihingen,09,Bayern,1215,644,571,171,89,82,123,57,66,14.1,7.3,6.7,10.1,4.7,5.4
09779177,Marktoffingen,09,Bayern,1297,686,611,175,113,62,55,21,34,13.5,8.7,4.8,4.2,1.6,2.6
09779224,"Wallerstein, M",09,Bayern,3379,1708,1671,393,246,147,256,160,96,11.6,7.3,4.4,7.6,4.7,2.8
09779117,Auhausen,09,Bayern,1055,541,514,113,75,38,44,29,15,10.7,7.1,3.6,4.2,2.7,1.4
09779138,Ehingen a.Ries,09,Bayern,799,403,396,90,49,41,40,19,21,11.3,6.1,5.1,5.0,2.4,2.6
09779154,Hainsfarth,09,Bayern,1419,705,714,153,101,52,117,81,36,10.8,7.1,3.7,8.2,5.7,2.5
09779180,Megesheim,09,Bayern,848,423,425,110,71,39,65,37,28,13.0,8.4,4.6,7.7,4.4,3.3
09779188,Munningen,09,Bayern,1766,926,840,245,170,75,195,97,98,13.9,9.6,4.2,11.0,5.5,5.5
09779197,"Oettingen i.Bay., St",09,Bayern,5166,2563,2603,568,361,207,783,511,272,11.0,7.0,4.0,15.2,9.9,5.3
09779111,Alerheim,09,Bayern,1619,791,828,196,106,90,191,93,98,12.1,6.5,5.6,11.8,5.7,6.1
09779112,Amerdingen,09,Bayern,851,421,430,97,49,48,69,40,29,11.4,5.8,5.6,8.1,4.7,3.4
09779130,Deiningen,09,Bayern,1824,899,925,230,133,97,188,115,73,12.6,7.3,5.3,10.3,6.3,4.0
09779136,Ederheim,09,Bayern,1122,572,550,156,94,62,95,55,40,13.9,8.4,5.5,8.5,4.9,3.6
09779146,Forheim,09,Bayern,565,283,282,68,42,26,45,23,22,12.0,7.4,4.6,8.0,4.1,3.9
09779162,Hohenaltheim,09,Bayern,569,307,262,75,45,30,55,38,17,13.2,7.9,5.3,9.7,6.7,3.0
09779184,Mönchsdeggingen,09,Bayern,1429,728,701,160,95,65,90,56,34,11.2,6.6,4.5,6.3,3.9,2.4
09779203,Reimlingen,09,Bayern,1350,710,640,168,97,71,75,47,28,12.4,7.2,5.3,5.6,3.5,2.1
09779226,Wechingen,09,Bayern,1428,733,695,182,110,72,149,87,62,12.7,7.7,5.0,10.4,6.1,4.3
09779148,Fünfstetten,09,Bayern,1339,680,659,110,68,42,52,33,19,8.2,5.1,3.1,3.9,2.5,1.4
09779167,Huisheim,09,Bayern,1570,787,783,146,102,44,70,39,31,9.3,6.5,2.8,4.5,2.5,2.0
09779198,Otting,09,Bayern,787,381,406,74,55,19,31,23,8,9.4,7.0,2.4,3.9,2.9,1.0
09779228,"Wemding, St",09,Bayern,5814,2847,2967,561,348,213,763,476,287,9.6,6.0,3.7,13.1,8.2,4.9
09779231,Wolferstadt,09,Bayern,1080,562,518,131,86,45,78,50,28,12.1,8.0,4.2,7.2,4.6,2.6
09779126,Buchdorf,09,Bayern,1696,878,818,158,100,58,127,77,50,9.3,5.9,3.4,7.5,4.5,2.9
09779129,Daiting,09,Bayern,758,409,349,72,46,26,24,16,8,9.5,6.1,3.4,3.2,2.1,1.1
09779186,"Monheim, St",09,Bayern,5029,2575,2454,440,263,177,381,264,117,8.7,5.2,3.5,7.6,5.2,2.3
09779206,Rögling,09,Bayern,637,333,304,53,42,11,26,17,9,8.3,6.6,1.7,4.1,2.7,1.4
09779217,Tagmersheim,09,Bayern,1096,579,517,101,73,28,53,36,17,9.2,6.7,2.6,4.8,3.3,1.6
09779149,Genderkingen,09,Bayern,1199,626,573,144,101,43,201,129,72,12.0,8.4,3.6,16.8,10.8,6.0
09779163,Holzheim,09,Bayern,1147,590,557,149,86,63,159,90,69,13.0,7.5,5.5,13.9,7.8,6.0
09779187,Münster,09,Bayern,1119,589,530,113,71,42,72,40,32,10.1,6.3,3.8,6.4,3.6,2.9
09779192,Niederschönenfeld,09,Bayern,1334,760,574,122,65,57,22,11,11,9.1,4.9,4.3,1.6,0.8,0.8
09779201,"Rain, St",09,Bayern,8897,4489,4408,961,533,428,1033,616,417,10.8,6.0,4.8,11.6,6.9,4.7
09780112,"Altusried, M",09,Bayern,10060,5090,4970,1232,699,533,921,520,401,12.2,6.9,5.3,9.2,5.2,4.0
09780114,Betzigau,09,Bayern,2845,1436,1409,335,219,116,228,137,91,11.8,7.7,4.1,8.0,4.8,3.2
09780115,Blaichach,09,Bayern,5751,2838,2913,695,392,303,544,293,251,12.1,6.8,5.3,9.5,5.1,4.4
09780117,"Buchenberg, M",09,Bayern,4046,2024,2022,443,291,152,473,261,212,10.9,7.2,3.8,11.7,6.5,5.2
09780118,Burgberg i.Allgäu,09,Bayern,3229,1570,1659,422,257,165,321,172,149,13.1,8.0,5.1,9.9,5.3,4.6
09780119,"Dietmannsried, M",09,Bayern,7904,3934,3970,939,557,382,1001,552,449,11.9,7.0,4.8,12.7,7.0,5.7
09780120,Durach,09,Bayern,7026,3458,3568,773,455,318,680,389,291,11.0,6.5,4.5,9.7,5.5,4.1
09780122,Haldenwang,09,Bayern,3755,1912,1843,417,246,171,263,163,100,11.1,6.6,4.6,7.0,4.3,2.7
09780123,"Bad Hindelang, M",09,Bayern,5033,2501,2532,561,347,214,601,352,249,11.1,6.9,4.3,11.9,7.0,4.9
09780124,"Immenstadt i.Allgäu, St",09,Bayern,14191,6928,7263,1666,961,705,1808,1027,781,11.7,6.8,5.0,12.7,7.2,5.5
09780125,Lauben,09,Bayern,3456,1731,1725,386,192,194,189,103,86,11.2,5.6,5.6,5.5,3.0,2.5
09780128,Oy-Mittelberg,09,Bayern,4500,2270,2230,528,292,236,396,212,184,11.7,6.5,5.2,8.8,4.7,4.1
09780132,"Oberstaufen, M",09,Bayern,7547,3687,3860,1005,582,423,1237,713,524,13.3,7.7,5.6,16.4,9.4,6.9
09780133,"Oberstdorf, M",09,Bayern,9638,4570,5068,1131,672,459,1478,844,634,11.7,7.0,4.8,15.3,8.8,6.6
09780137,Rettenberg,09,Bayern,4391,2244,2147,644,353,291,385,192,193,14.7,8.0,6.6,8.8,4.4,4.4
09780139,"Sonthofen, St",09,Bayern,21300,10163,11137,2559,1459,1100,2230,1265,965,12.0,6.8,5.2,10.5,5.9,4.5
09780140,"Sulzberg, M",09,Bayern,4834,2409,2425,605,354,251,446,251,195,12.5,7.3,5.2,9.2,5.2,4.0
09780143,Waltenhofen,09,Bayern,9066,4520,4546,1058,607,451,867,485,382,11.7,6.7,5.0,9.6,5.3,4.2
09780145,"Wertach, M",09,Bayern,2436,1197,1239,348,221,127,319,203,116,14.3,9.1,5.2,13.1,8.3,4.8
09780146,"Wiggensbach, M",09,Bayern,4955,2500,2455,589,327,262,482,258,224,11.9,6.6,5.3,9.7,5.2,4.5
09780147,Wildpoldsried,09,Bayern,2554,1273,1281,331,213,118,244,148,96,13.0,8.3,4.6,9.6,5.8,3.8
09780113,Balderschwang,09,Bayern,327,160,167,25,16,9,31,20,11,7.6,4.9,2.8,9.5,6.1,3.4
09780116,Bolsterlang,09,Bayern,1069,541,528,149,94,55,94,55,39,13.9,8.8,5.1,8.8,5.1,3.6
09780121,Fischen i.Allgäu,09,Bayern,3131,1525,1606,434,256,178,328,201,127,13.9,8.2,5.7,10.5,6.4,4.1
09780131,Obermaiselstein,09,Bayern,974,495,479,137,69,68,134,84,50,14.1,7.1,7.0,13.8,8.6,5.1
09780134,Ofterschwang,09,Bayern,2028,1022,1006,210,113,97,303,175,128,10.4,5.6,4.8,14.9,8.6,6.3
09780127,Missen-Wilhams,09,Bayern,1433,742,691,161,91,70,130,80,50,11.2,6.4,4.9,9.1,5.6,3.5
09780144,"Weitnau, M",09,Bayern,5193,2602,2591,654,395,259,409,259,150,12.6,7.6,5.0,7.9,5.0,2.9
