ags,name,bundesland_id,bundesland,bevoelkerung_total,bevoelkerung_maennlich,bevoelkerung_weiblich,mj_wohnort_insgesamt,mj_wohnort_ausschliesslich,mj_wohnort_nebenjob,mj_arbeitsort_insgesamt,mj_arbeitsort_ausschliesslich,mj_arbeitsort_nebenjob,mj_wohnort_insgesamt_prozent,mj_wohnort_ausschliesslich_prozent,mj_wohnort_nebenjob_prozent,mj_arbeitsort_insgesamt_prozent,mj_arbeitsort_ausschliesslich_prozent,mj_arbeitsort_nebenjob_prozent
06411000,"Darmstadt, Wissenschaftsstadt",06,Hessen,155353,78915,76438,14906,10286,4620,19376,13149,6227,9.6,6.6,3.0,12.5,8.5,4.0
06412000,"Frankfurt am Main, Stadt",06,Hessen,732688,362515,370173,58582,35867,22715,78706,48248,30458,8.0,4.9,3.1,10.7,6.6,4.2
06413000,"Offenbach am Main, Stadt",06,Hessen,123734,61609,62125,11959,7283,4676,11736,7522,4214,9.7,5.9,3.8,9.5,6.1,3.4
06414000,"Wiesbaden, Landeshauptstadt",06,Hessen,276218,131901,144317,25160,15555,9605,26104,16367,9737,9.1,5.6,3.5,9.5,5.9,3.5
06431001,Abtsteinach,06,Hessen,2360,1179,1181,227,156,71,157,109,48,9.6,6.6,3.0,6.7,4.6,2.0
06431002,"Bensheim, Stadt",06,Hessen,40051,19562,20489,3875,2592,1283,4417,2940,1477,9.7,6.5,3.2,11.0,7.3,3.7
06431003,Biblis,06,Hessen,8910,4525,4385,742,547,195,501,373,128,8.3,6.1,2.2,5.6,4.2,1.4
06431004,Birkenau,06,Hessen,9933,4827,5106,1102,791,311,814,571,243,11.1,8.0,3.1,8.2,5.7,2.4
06431005,"Bürstadt, Stadt",06,Hessen,16060,7987,8073,1519,1071,448,1083,769,314,9.5,6.7,2.8,6.7,4.8,2.0
06431006,Einhausen,06,Hessen,6281,3155,3126,579,368,211,298,229,69,9.2,5.9,3.4,4.7,3.6,1.1
06431007,Fürth,06,Hessen,10465,5204,5261,1154,768,386,943,635,308,11.0,7.3,3.7,9.0,6.1,2.9
06431008,Gorxheimertal,06,Hessen,4160,2085,2075,420,278,142,196,120,76,10.1,6.7,3.4,4.7,2.9,1.8
06431009,Grasellenbach,06,Hessen,3995,2070,1925,425,297,128,304,188,116,10.6,7.4,3.2,7.6,4.7,2.9
06431010,Groß-Rohrheim,06,Hessen,3768,1911,1857,304,201,103,244,162,82,8.1,5.3,2.7,6.5,4.3,2.2
06431011,"Heppenheim (Bergstraße), Kreisstadt",06,Hessen,25284,12405,12879,2651,1745,906,2609,1702,907,10.5,6.9,3.6,10.3,6.7,3.6
06431012,"Hirschhorn (Neckar), Stadt",06,Hessen,3436,1704,1732,327,218,109,266,165,101,9.5,6.3,3.2,7.7,4.8,2.9
06431013,"Lampertheim, Stadt",06,Hessen,32303,15952,16351,2988,1966,1022,2787,1766,1021,9.2,6.1,3.2,8.6,5.5,3.2
06431014,Lautertal (Odenwald),06,Hessen,7201,3528,3673,733,500,233,661,448,213,10.2,6.9,3.2,9.2,6.2,3.0
06431015,"Lindenfels, Stadt",06,Hessen,5086,2520,2566,539,369,170,401,279,122,10.6,7.3,3.3,7.9,5.5,2.4
06431016,"Lorsch, Karolingerstadt",06,Hessen,13515,6550,6965,1287,848,439,1331,824,507,9.5,6.3,3.2,9.8,6.1,3.8
06431017,Mörlenbach,06,Hessen,9972,4930,5042,1079,707,372,852,547,305,10.8,7.1,3.7,8.5,5.5,3.1
06431018,"Neckarsteinach, Stadt",06,Hessen,3889,1946,1943,344,235,109,219,153,66,8.8,6.0,2.8,5.6,3.9,1.7
06431019,Rimbach,06,Hessen,8571,4229,4342,888,619,269,778,530,248,10.4,7.2,3.1,9.1,6.2,2.9
06431020,"Viernheim, Stadt",06,Hessen,34146,16788,17358,3525,2314,1211,3740,2464,1276,10.3,6.8,3.5,11.0,7.2,3.7
06431021,Wald-Michelbach,06,Hessen,10614,5311,5303,1225,802,423,946,632,314,11.5,7.6,4.0,8.9,6.0,3.0
06431022,"Zwingenberg, Stadt",06,Hessen,6928,3460,3468,633,451,182,473,334,139,9.1,6.5,2.6,6.8,4.8,2.0
06432001,Alsbach-Hähnlein,06,Hessen,9299,4596,4703,775,486,289,808,509,299,8.3,5.2,3.1,8.7,5.5,3.2
06432002,"Babenhausen, Stadt",06,Hessen,16728,8457,8271,1613,1037,576,1166,807,359,9.6,6.2,3.4,7.0,4.8,2.1
06432003,Bickenbach,06,Hessen,5777,2794,2983,469,286,183,396,262,134,8.1,5.0,3.2,6.9,4.5,2.3
06432004,"Dieburg, Stadt",06,Hessen,15500,7606,7894,1388,933,455,2095,1431,664,9.0,6.0,2.9,13.5,9.2,4.3
06432005,Eppertshausen,06,Hessen,6231,3138,3093,572,380,192,434,266,168,9.2,6.1,3.1,7.0,4.3,2.7
06432006,Erzhausen,06,Hessen,7864,3906,3958,676,439,237,388,242,146,8.6,5.6,3.0,4.9,3.1,1.9
06432007,Fischbachtal,06,Hessen,2627,1318,1309,254,148,106,180,112,68,9.7,5.6,4.0,6.9,4.3,2.6
06432008,"Griesheim, Stadt",06,Hessen,26907,13440,13467,2523,1566,957,2804,1619,1185,9.4,5.8,3.6,10.4,6.0,4.4
06432009,"Groß-Bieberau, Stadt",06,Hessen,4730,2362,2368,439,309,130,348,235,113,9.3,6.5,2.7,7.4,5.0,2.4
06432010,"Groß-Umstadt, Stadt",06,Hessen,20821,10295,10526,2051,1341,710,2341,1536,805,9.9,6.4,3.4,11.2,7.4,3.9
06432011,Groß-Zimmern,06,Hessen,14069,7023,7046,1462,967,495,1560,898,662,10.4,6.9,3.5,11.1,6.4,4.7
06432012,Messel,06,Hessen,3972,1996,1976,350,218,132,351,224,127,8.8,5.5,3.3,8.8,5.6,3.2
06432013,Modautal,06,Hessen,5100,2543,2557,504,328,176,296,197,99,9.9,6.4,3.5,5.8,3.9,1.9
06432014,Mühltal,06,Hessen,13753,6833,6920,1212,773,439,948,582,366,8.8,5.6,3.2,6.9,4.2,2.7
06432015,Münster,06,Hessen,14076,6921,7155,1385,892,493,717,436,281,9.8,6.3,3.5,5.1,3.1,2.0
06432016,"Ober-Ramstadt, Stadt",06,Hessen,15029,7398,7631,1403,897,506,1071,731,340,9.3,6.0,3.4,7.1,4.9,2.3
06432017,Otzberg,06,Hessen,6360,3193,3167,621,428,193,427,301,126,9.8,6.7,3.0,6.7,4.7,2.0
06432018,"Pfungstadt, Stadt",06,Hessen,24548,12110,12438,2459,1549,910,1758,1165,593,10.0,6.3,3.7,7.2,4.7,2.4
06432019,"Reinheim, Stadt",06,Hessen,16277,8047,8230,1492,1036,456,1027,692,335,9.2,6.4,2.8,6.3,4.3,2.1
06432020,Roßdorf,06,Hessen,12250,6080,6170,1144,787,357,768,525,243,9.3,6.4,2.9,6.3,4.3,2.0
06432021,Schaafheim,06,Hessen,9221,4627,4594,885,604,281,632,391,241,9.6,6.6,3.0,6.9,4.2,2.6
06432022,Seeheim-Jugenheim,06,Hessen,16218,7867,8351,1277,861,416,1236,798,438,7.9,5.3,2.6,7.6,4.9,2.7
06432023,"Weiterstadt, Stadt",06,Hessen,25416,12868,12548,2441,1489,952,2494,1620,874,9.6,5.9,3.7,9.8,6.4,3.4
06433001,Biebesheim am Rhein,06,Hessen,6881,3496,3385,632,351,281,446,279,167,9.2,5.1,4.1,6.5,4.1,2.4
06433002,Bischofsheim,06,Hessen,13104,6532,6572,1189,748,441,871,544,327,9.1,5.7,3.4,6.6,4.2,2.5
06433003,Büttelborn,06,Hessen,14574,7180,7394,1270,790,480,762,495,267,8.7,5.4,3.3,5.2,3.4,1.8
06433004,"Gernsheim, Schöfferstadt",06,Hessen,10069,5040,5029,948,600,348,958,567,391,9.4,6.0,3.5,9.5,5.6,3.9
06433005,"Ginsheim-Gustavsburg, Stadt",06,Hessen,16208,7917,8291,1569,982,587,1216,776,440,9.7,6.1,3.6,7.5,4.8,2.7
06433006,"Groß-Gerau, Stadt",06,Hessen,24648,12245,12403,2321,1451,870,2291,1459,832,9.4,5.9,3.5,9.3,5.9,3.4
06433007,"Kelsterbach, Stadt",06,Hessen,15721,8106,7615,1452,772,680,1782,835,947,9.2,4.9,4.3,11.3,5.3,6.0
06433008,"Mörfelden-Walldorf, Stadt",06,Hessen,33623,16879,16744,2905,1756,1149,3652,2223,1429,8.6,5.2,3.4,10.9,6.6,4.3
06433009,Nauheim,06,Hessen,10510,5211,5299,904,570,334,1181,693,488,8.6,5.4,3.2,11.2,6.6,4.6
06433010,"Raunheim, Stadt",06,Hessen,15636,7809,7827,1439,830,609,908,502,406,9.2,5.3,3.9,5.8,3.2,2.6
06433011,"Riedstadt, Stadt",06,Hessen,22998,11456,11542,1936,1195,741,1347,826,521,8.4,5.2,3.2,5.9,3.6,2.3
06433012,"Rüsselsheim am Main, Stadt",06,Hessen,63030,31265,31765,5879,3608,2271,4765,3106,1659,9.3,5.7,3.6,7.6,4.9,2.6
06433013,Stockstadt am Rhein,06,Hessen,5882,2972,2910,579,351,228,429,256,173,9.8,6.0,3.9,7.3,4.4,2.9
06433014,Trebur,06,Hessen,13158,6547,6611,1209,753,456,838,523,315,9.2,5.7,3.5,6.4,4.0,2.4
06434001,"Bad Homburg v. d. Höhe, Stadt",06,Hessen,53244,25095,28149,4359,2699,1660,5738,3505,2233,8.2,5.1,3.1,10.8,6.6,4.2
06434002,"Friedrichsdorf, Stadt",06,Hessen,25092,12297,12795,2090,1322,768,1761,1096,665,8.3,5.3,3.1,7.0,4.4,2.7
06434003,Glashütten,06,Hessen,5376,2640,2736,412,270,142,236,152,84,7.7,5.0,2.6,4.4,2.8,1.6
06434004,Grävenwiesbach,06,Hessen,5278,2691,2587,458,313,145,250,160,90,8.7,5.9,2.7,4.7,3.0,1.7
06434005,"Königstein im Taunus, Stadt",06,Hessen,16393,7754,8639,1199,785,414,1496,937,559,7.3,4.8,2.5,9.1,5.7,3.4
06434006,"Kronberg im Taunus, Stadt",06,Hessen,18330,8583,9747,1278,842,436,1631,1022,609,7.0,4.6,2.4,8.9,5.6,3.3
06434007,"Neu-Anspach, Stadt",06,Hessen,14624,7210,7414,1341,861,480,1148,715,433,9.2,5.9,3.3,7.9,4.9,3.0
06434008,"Oberursel (Taunus), Stadt",06,Hessen,45723,22136,23587,3404,2158,1246,3779,2400,1379,7.4,4.7,2.7,8.3,5.2,3.0
06434009,Schmitten,06,Hessen,9047,4531,4516,779,499,280,506,335,171,8.6,5.5,3.1,5.6,3.7,1.9
06434010,"Steinbach (Taunus), Stadt",06,Hessen,10453,5039,5414,994,629,365,731,465,266,9.5,6.0,3.5,7.0,4.4,2.5
06434011,"Usingen, Stadt",06,Hessen,14025,6901,7124,1299,854,445,1163,757,406,9.3,6.1,3.2,8.3,5.4,2.9
06434012,Wehrheim,06,Hessen,9355,4646,4709,821,535,286,671,424,247,8.8,5.7,3.1,7.2,4.5,2.6
06434013,Weilrod,06,Hessen,6487,3274,3213,646,417,229,370,226,144,10.0,6.4,3.5,5.7,3.5,2.2
06435001,"Bad Orb, Stadt",06,Hessen,9631,4576,5055,841,562,279,933,604,329,8.7,5.8,2.9,9.7,6.3,3.4
06435002,"Bad Soden-Salmünster, Stadt",06,Hessen,13361,6581,6780,1322,906,416,1240,856,384,9.9,6.8,3.1,9.3,6.4,2.9
06435003,Biebergemünd,06,Hessen,8384,4240,4144,862,596,266,566,385,181,10.3,7.1,3.2,6.8,4.6,2.2
06435004,Birstein,06,Hessen,6269,3143,3126,789,535,254,642,450,192,12.6,8.5,4.1,10.2,7.2,3.1
06435005,Brachttal,06,Hessen,5137,2511,2626,501,346,155,309,220,89,9.8,6.7,3.0,6.0,4.3,1.7
06435006,"Bruchköbel, Stadt",06,Hessen,20418,9942,10476,1732,1118,614,1329,902,427,8.5,5.5,3.0,6.5,4.4,2.1
06435007,"Erlensee, Stadt",06,Hessen,14005,6949,7056,1296,803,493,1410,880,530,9.3,5.7,3.5,10.1,6.3,3.8
06435008,Flörsbachtal,06,Hessen,2343,1166,1177,235,150,85,134,71,63,10.0,6.4,3.6,5.7,3.0,2.7
06435009,Freigericht,06,Hessen,14419,7117,7302,1390,927,463,1363,848,515,9.6,6.4,3.2,9.5,5.9,3.6
06435010,"Gelnhausen, Barbarossast., Krst.",06,Hessen,22687,11165,11522,2067,1389,678,3294,2210,1084,9.1,6.1,3.0,14.5,9.7,4.8
06435011,Großkrotzenburg,06,Hessen,7497,3729,3768,670,415,255,377,229,148,8.9,5.5,3.4,5.0,3.1,2.0
06435012,Gründau,06,Hessen,14633,7164,7469,1427,933,494,1027,701,326,9.8,6.4,3.4,7.0,4.8,2.2
06435013,Hammersbach,06,Hessen,4797,2366,2431,412,269,143,455,291,164,8.6,5.6,3.0,9.5,6.1,3.4
06435014,"Hanau, Brüder-Grimm-Stadt",06,Hessen,92643,45508,47135,8416,5218,3198,8855,5669,3186,9.1,5.6,3.5,9.6,6.1,3.4
06435015,Hasselroth,06,Hessen,7261,3607,3654,624,395,229,452,278,174,8.6,5.4,3.2,6.2,3.8,2.4
06435016,Jossgrund,06,Hessen,3448,1735,1713,417,302,115,290,210,80,12.1,8.8,3.3,8.4,6.1,2.3
06435017,"Langenselbold, Stadt",06,Hessen,13810,6716,7094,1341,839,502,1485,939,546,9.7,6.1,3.6,10.8,6.8,4.0
06435018,Linsengericht,06,Hessen,9944,4920,5024,926,624,302,700,473,227,9.3,6.3,3.0,7.0,4.8,2.3
06435019,"Maintal, Stadt",06,Hessen,38208,18632,19576,3453,2132,1321,2420,1531,889,9.0,5.6,3.5,6.3,4.0,2.3
06435020,Neuberg,06,Hessen,5346,2654,2692,465,302,163,230,128,102,8.7,5.6,3.0,4.3,2.4,1.9
06435021,"Nidderau, Stadt",06,Hessen,19964,9845,10119,1668,1085,583,1102,726,376,8.4,5.4,2.9,5.5,3.6,1.9
06435022,Niederdorfelden,06,Hessen,3816,1855,1961,335,196,139,316,222,94,8.8,5.1,3.6,8.3,5.8,2.5
06435023,Rodenbach,06,Hessen,11176,5467,5709,926,606,320,644,386,258,8.3,5.4,2.9,5.8,3.5,2.3
06435024,Ronneburg,06,Hessen,3406,1673,1733,306,196,110,218,154,64,9.0,5.8,3.2,6.4,4.5,1.9
06435025,"Schlüchtern, Stadt",06,Hessen,15827,7797,8030,1516,1014,502,1476,1070,406,9.6,6.4,3.2,9.3,6.8,2.6
06435026,Schöneck,06,Hessen,11812,5806,6006,950,602,348,675,431,244,8.0,5.1,2.9,5.7,3.6,2.1
06435027,Sinntal,06,Hessen,8961,4507,4454,835,599,236,544,389,155,9.3,6.7,2.6,6.1,4.3,1.7
06435028,"Steinau an der Straße, Brüder-Grimm-Stadt",06,Hessen,10373,5143,5230,993,691,302,780,519,261,9.6,6.7,2.9,7.5,5.0,2.5
06435029,"Wächtersbach, Stadt",06,Hessen,12380,6078,6302,1214,817,397,1016,677,339,9.8,6.6,3.2,8.2,5.5,2.7
06436001,"Bad Soden am Taunus, Stadt",06,Hessen,22161,10500,11661,1581,987,594,1615,961,654,7.1,4.5,2.7,7.3,4.3,3.0
06436002,"Eppstein, Stadt",06,Hessen,13626,6745,6881,1093,706,387,742,494,248,8.0,5.2,2.8,5.4,3.6,1.8
06436003,"Eschborn, Stadt",06,Hessen,20824,10174,10650,1752,1072,680,2601,1542,1059,8.4,5.1,3.3,12.5,7.4,5.1
06436004,"Flörsheim am Main, Stadt",06,Hessen,20623,10040,10583,1909,1127,782,1708,1023,685,9.3,5.5,3.8,8.3,5.0,3.3
06436005,"Hattersheim am Main, Stadt",06,Hessen,26908,13400,13508,2290,1414,876,1778,1088,690,8.5,5.3,3.3,6.6,4.0,2.6
06436006,"Hochheim am Main, Stadt",06,Hessen,17057,8281,8776,1660,994,666,1434,847,587,9.7,5.8,3.9,8.4,5.0,3.4
06436007,"Hofheim am Taunus, Kreisstadt",06,Hessen,39476,19225,20251,3216,2072,1144,3505,2198,1307,8.1,5.2,2.9,8.9,5.6,3.3
06436008,"Kelkheim (Taunus), Stadt",06,Hessen,28452,13947,14505,2419,1514,905,2290,1403,887,8.5,5.3,3.2,8.0,4.9,3.1
06436009,Kriftel,06,Hessen,10898,5275,5623,933,563,370,809,525,284,8.6,5.2,3.4,7.4,4.8,2.6
06436010,Liederbach am Taunus,06,Hessen,8939,4474,4465,706,452,254,569,281,288,7.9,5.1,2.8,6.4,3.1,3.2
06436011,"Schwalbach am Taunus, Stadt",06,Hessen,15203,7291,7912,1163,738,425,846,512,334,7.6,4.9,2.8,5.6,3.4,2.2
06436012,Sulzbach (Taunus),06,Hessen,8681,4240,4441,692,412,280,1472,953,519,8.0,4.7,3.2,17.0,11.0,6.0
06437001,"Bad König, Stadt",06,Hessen,9544,4634,4910,925,629,296,899,581,318,9.7,6.6,3.1,9.4,6.1,3.3
06437002,"Beerfelden, Stadt",06,Hessen,6399,3234,3165,672,452,220,501,305,196,10.5,7.1,3.4,7.8,4.8,3.1
06437003,Brensbach,06,Hessen,5041,2536,2505,460,323,137,439,317,122,9.1,6.4,2.7,8.7,6.3,2.4
06437004,"Breuberg, Stadt",06,Hessen,7488,3690,3798,762,511,251,463,343,120,10.2,6.8,3.4,6.2,4.6,1.6
06437005,Brombachtal,06,Hessen,3475,1723,1752,381,243,138,235,150,85,11.0,7.0,4.0,6.8,4.3,2.4
06437006,"Erbach, Kreisstadt",06,Hessen,13401,6503,6898,1418,966,452,1705,1099,606,10.6,7.2,3.4,12.7,8.2,4.5
06437007,Fränkisch-Crumbach,06,Hessen,3184,1552,1632,320,211,109,252,167,85,10.1,6.6,3.4,7.9,5.2,2.7
06437008,Hesseneck,06,Hessen,640,319,321,70,39,31,25,16,9,10.9,6.1,4.8,3.9,2.5,1.4
06437009,Höchst i. Odw.,06,Hessen,10076,5032,5044,1040,725,315,823,581,242,10.3,7.2,3.1,8.2,5.8,2.4
06437010,Lützelbach,06,Hessen,6910,3454,3456,735,503,232,410,290,120,10.6,7.3,3.4,5.9,4.2,1.7
06437011,"Michelstadt, Stadt",06,Hessen,16642,8393,8249,1810,1193,617,2327,1390,937,10.9,7.2,3.7,14.0,8.4,5.6
06437012,Mossautal,06,Hessen,2451,1222,1229,253,155,98,204,112,92,10.3,6.3,4.0,8.3,4.6,3.8
06437013,Reichelsheim (Odenwald),06,Hessen,8540,4254,4286,1029,678,351,884,566,318,12.0,7.9,4.1,10.4,6.6,3.7
06437014,Rothenberg,06,Hessen,2265,1112,1153,215,119,96,112,72,40,9.5,5.3,4.2,4.9,3.2,1.8
06437015,Sensbachtal,06,Hessen,944,482,462,88,56,32,52,35,17,9.3,5.9,3.4,5.5,3.7,1.8
06438001,"Dietzenbach, Kreisstadt",06,Hessen,33397,16696,16701,3055,1987,1068,3284,2110,1174,9.1,5.9,3.2,9.8,6.3,3.5
06438002,"Dreieich, Stadt",06,Hessen,40601,19915,20686,3714,2343,1371,3328,2132,1196,9.1,5.8,3.4,8.2,5.3,2.9
06438003,Egelsbach,06,Hessen,11494,5744,5750,930,588,342,897,557,340,8.1,5.1,3.0,7.8,4.8,3.0
06438004,Hainburg,06,Hessen,14254,6846,7408,1501,916,585,1070,664,406,10.5,6.4,4.1,7.5,4.7,2.8
06438005,"Heusenstamm, Stadt",06,Hessen,18752,9201,9551,1544,978,566,1162,777,385,8.2,5.2,3.0,6.2,4.1,2.1
06438006,"Langen (Hessen), Stadt",06,Hessen,37026,18249,18777,3373,2022,1351,2595,1595,1000,9.1,5.5,3.6,7.0,4.3,2.7
06438007,Mainhausen,06,Hessen,9211,4602,4609,804,504,300,861,429,432,8.7,5.5,3.3,9.3,4.7,4.7
06438008,"Mühlheim am Main, Stadt",06,Hessen,28170,13996,14174,2615,1583,1032,2084,1295,789,9.3,5.6,3.7,7.4,4.6,2.8
06438009,"Neu-Isenburg, Stadt",06,Hessen,37565,18571,18994,3388,2044,1344,5095,3112,1983,9.0,5.4,3.6,13.6,8.3,5.3
06438010,"Obertshausen, Stadt",06,Hessen,24443,11892,12551,2279,1386,893,2808,1804,1004,9.3,5.7,3.7,11.5,7.4,4.1
06438011,"Rodgau, Stadt",06,Hessen,44222,21974,22248,4018,2539,1479,3461,2064,1397,9.1,5.7,3.3,7.8,4.7,3.2
06438012,"Rödermark, Stadt",06,Hessen,27242,13293,13949,2507,1590,917,2549,1697,852,9.2,5.8,3.4,9.4,6.2,3.1
06438013,"Seligenstadt, Stadt",06,Hessen,20980,10185,10795,1946,1243,703,2480,1551,929,9.3,5.9,3.4,11.8,7.4,4.4
06439001,Aarbergen,06,Hessen,6006,2987,3019,607,414,193,418,291,127,10.1,6.9,3.2,7.0,4.8,2.1
06439002,"Bad Schwalbach, Kreisstadt",06,Hessen,10697,5305,5392,1035,669,366,935,592,343,9.7,6.3,3.4,8.7,5.5,3.2
06439003,"Eltville am Rhein, Stadt",06,Hessen,16970,8233,8737,1682,1049,633,1898,1155,743,9.9,6.2,3.7,11.2,6.8,4.4
06439004,"Geisenheim, Hochschulstadt",06,Hessen,11690,5706,5984,1373,891,482,1328,871,457,11.7,7.6,4.1,11.4,7.5,3.9
06439005,Heidenrod,06,Hessen,7898,3982,3916,761,474,287,423,260,163,9.6,6.0,3.6,5.4,3.3,2.1
06439006,Hohenstein,06,Hessen,6112,3109,3003,563,369,194,277,175,102,9.2,6.0,3.2,4.5,2.9,1.7
06439007,Hünstetten,06,Hessen,10421,5189,5232,948,599,349,521,326,195,9.1,5.7,3.3,5.0,3.1,1.9
06439008,"Idstein, Stadt",06,Hessen,24108,11602,12506,2249,1500,749,2653,1761,892,9.3,6.2,3.1,11.0,7.3,3.7
06439009,Kiedrich,06,Hessen,4106,2007,2099,331,189,142,280,168,112,8.1,4.6,3.5,6.8,4.1,2.7
06439010,"Lorch, Stadt",06,Hessen,4056,2078,1978,416,293,123,336,218,118,10.3,7.2,3.0,8.3,5.4,2.9
06439011,Niedernhausen,06,Hessen,14544,7276,7268,1175,767,408,897,595,302,8.1,5.3,2.8,6.2,4.1,2.1
06439012,"Oestrich-Winkel, Stadt",06,Hessen,11632,5661,5971,1261,805,456,979,604,375,10.8,6.9,3.9,8.4,5.2,3.2
06439013,"Rüdesheim am Rhein, Stadt",06,Hessen,9873,4932,4941,763,472,291,1077,702,375,7.7,4.8,2.9,10.9,7.1,3.8
06439014,Schlangenbad,06,Hessen,6290,3183,3107,515,318,197,275,172,103,8.2,5.1,3.1,4.4,2.7,1.6
06439015,"Taunusstein, Stadt",06,Hessen,29063,14036,15027,2732,1793,939,2757,1828,929,9.4,6.2,3.2,9.5,6.3,3.2
06439016,Waldems,06,Hessen,5155,2555,2600,415,271,144,315,205,110,8.1,5.3,2.8,6.1,4.0,2.1
06439017,Walluf,06,Hessen,5493,2673,2820,525,315,210,552,310,242,9.6,5.7,3.8,10.0,5.6,4.4
06440001,Altenstadt,06,Hessen,11859,5904,5955,1116,777,339,954,688,266,9.4,6.6,2.9,8.0,5.8,2.2
06440002,"Bad Nauheim, Stadt",06,Hessen,31630,14902,16728,2664,1694,970,2918,1938,980,8.4,5.4,3.1,9.2,6.1,3.1
06440003,"Bad Vilbel, Stadt",06,Hessen,33020,15950,17070,2743,1737,1006,3041,1890,1151,8.3,5.3,3.0,9.2,5.7,3.5
06440004,"Büdingen, Stadt",06,Hessen,21785,10898,10887,2175,1458,717,1932,1290,642,10.0,6.7,3.3,8.9,5.9,2.9
06440005,"Butzbach, Friedrich-Ludwig-Weidig-Stadt",06,Hessen,25557,12790,12767,2191,1414,777,1936,1284,652,8.6,5.5,3.0,7.6,5.0,2.6
06440006,Echzell,06,Hessen,5701,2841,2860,484,341,143,355,248,107,8.5,6.0,2.5,6.2,4.4,1.9
06440007,"Florstadt, Stadt",06,Hessen,8695,4319,4376,801,551,250,533,362,171,9.2,6.3,2.9,6.1,4.2,2.0
06440008,"Friedberg (Hessen), Kreisstadt",06,Hessen,28156,14013,14143,2620,1800,820,3050,2080,970,9.3,6.4,2.9,10.8,7.4,3.4
06440009,"Gedern, Stadt",06,Hessen,7456,3768,3688,845,563,282,670,467,203,11.3,7.6,3.8,9.0,6.3,2.7
06440010,Glauburg,06,Hessen,3032,1525,1507,307,224,83,190,154,36,10.1,7.4,2.7,6.3,5.1,1.2
06440011,Hirzenhain,06,Hessen,2828,1432,1396,292,196,96,207,152,55,10.3,6.9,3.4,7.3,5.4,1.9
06440012,"Karben, Stadt",06,Hessen,22163,11082,11081,1960,1261,699,1631,1078,553,8.8,5.7,3.2,7.4,4.9,2.5
06440013,Kefenrod,06,Hessen,2726,1343,1383,277,200,77,150,106,44,10.2,7.3,2.8,5.5,3.9,1.6
06440014,Limeshain,06,Hessen,5480,2728,2752,498,322,176,447,276,171,9.1,5.9,3.2,8.2,5.0,3.1
06440015,"Münzenberg, Stadt",06,Hessen,5596,2773,2823,526,359,167,317,203,114,9.4,6.4,3.0,5.7,3.6,2.0
06440016,"Nidda, Stadt",06,Hessen,17299,8663,8636,1663,1152,511,1461,1021,440,9.6,6.7,3.0,8.4,5.9,2.5
06440017,"Niddatal, Stadt",06,Hessen,9470,4739,4731,819,530,289,478,313,165,8.6,5.6,3.1,5.0,3.3,1.7
06440018,Ober-Mörlen,06,Hessen,5720,2854,2866,517,366,151,372,243,129,9.0,6.4,2.6,6.5,4.2,2.3
06440019,"Ortenberg, Stadt",06,Hessen,9091,4490,4601,923,634,289,638,448,190,10.2,7.0,3.2,7.0,4.9,2.1
06440020,Ranstadt,06,Hessen,5077,2524,2553,534,364,170,510,357,153,10.5,7.2,3.3,10.0,7.0,3.0
06440021,"Reichelsheim (Wetterau), Stadt",06,Hessen,6856,3420,3436,586,371,215,367,252,115,8.5,5.4,3.1,5.4,3.7,1.7
06440022,Rockenberg,06,Hessen,4361,2190,2171,425,281,144,664,493,171,9.7,6.4,3.3,15.2,11.3,3.9
06440023,"Rosbach v. d. Höhe, Stadt",06,Hessen,12250,6073,6177,994,614,380,930,608,322,8.1,5.0,3.1,7.6,5.0,2.6
06440024,Wölfersheim,06,Hessen,9925,4946,4979,908,619,289,678,465,213,9.1,6.2,2.9,6.8,4.7,2.1
06440025,Wöllstadt,06,Hessen,6198,3086,3112,553,355,198,266,157,109,8.9,5.7,3.2,4.3,2.5,1.8
06531001,"Allendorf (Lumda), Stadt",06,Hessen,4089,2074,2015,391,261,130,259,159,100,9.6,6.4,3.2,6.3,3.9,2.4
06531002,Biebertal,06,Hessen,10052,4905,5147,934,619,315,657,447,210,9.3,6.2,3.1,6.5,4.4,2.1
06531003,Buseck,06,Hessen,12903,6398,6505,1203,783,420,911,612,299,9.3,6.1,3.3,7.1,4.7,2.3
06531004,Fernwald,06,Hessen,6607,3307,3300,598,400,198,486,314,172,9.1,6.1,3.0,7.4,4.8,2.6
06531005,"Gießen, Universitätsstadt",06,Hessen,84455,41822,42633,9715,7482,2233,13737,9993,3744,11.5,8.9,2.6,16.3,11.8,4.4
06531006,"Grünberg, Stadt",06,Hessen,13634,6735,6899,1441,982,459,1157,812,345,10.6,7.2,3.4,8.5,6.0,2.5
06531007,Heuchelheim,06,Hessen,7501,3686,3815,771,554,217,618,448,170,10.3,7.4,2.9,8.2,6.0,2.3
06531008,"Hungen, Stadt",06,Hessen,12471,6177,6294,1272,861,411,926,604,322,10.2,6.9,3.3,7.4,4.8,2.6
06531009,Langgöns,06,Hessen,11494,5655,5839,1122,726,396,926,626,300,9.8,6.3,3.4,8.1,5.4,2.6
06531010,"Laubach, Stadt",06,Hessen,9632,4679,4953,930,641,289,660,463,197,9.7,6.7,3.0,6.9,4.8,2.0
06531011,"Lich, Stadt",06,Hessen,13290,6509,6781,1325,882,443,1254,846,408,10.0,6.6,3.3,9.4,6.4,3.1
06531012,"Linden, Stadt",06,Hessen,12747,6406,6341,1206,827,379,1088,752,336,9.5,6.5,3.0,8.5,5.9,2.6
06531013,"Lollar, Stadt",06,Hessen,10029,5003,5026,954,627,327,787,532,255,9.5,6.3,3.3,7.8,5.3,2.5
06531014,"Pohlheim, Stadt",06,Hessen,17890,8703,9187,1680,1169,511,979,689,290,9.4,6.5,2.9,5.5,3.9,1.6
06531015,Rabenau,06,Hessen,4976,2512,2464,470,320,150,328,204,124,9.4,6.4,3.0,6.6,4.1,2.5
06531016,Reiskirchen,06,Hessen,10298,5045,5253,1069,712,357,785,531,254,10.4,6.9,3.5,7.6,5.2,2.5
06531017,"Staufenberg, Stadt",06,Hessen,8244,4044,4200,771,491,280,608,392,216,9.4,6.0,3.4,7.4,4.8,2.6
06531018,Wettenberg,06,Hessen,12193,5874,6319,1101,741,360,3047,1985,1062,9.0,6.1,3.0,25.0,16.3,8.7
06532001,"Aßlar, Stadt",06,Hessen,13672,6747,6925,1453,953,500,1473,1019,454,10.6,7.0,3.7,10.8,7.5,3.3
06532002,Bischoffen,06,Hessen,3378,1705,1673,343,236,107,291,211,80,10.2,7.0,3.2,8.6,6.2,2.4
06532003,"Braunfels, Stadt",06,Hessen,10862,5266,5596,1064,711,353,745,492,253,9.8,6.5,3.2,6.9,4.5,2.3
06532004,Breitscheid,06,Hessen,4762,2381,2381,632,458,174,433,303,130,13.3,9.6,3.7,9.1,6.4,2.7
06532005,Dietzhölztal,06,Hessen,5757,2877,2880,607,446,161,471,343,128,10.5,7.7,2.8,8.2,6.0,2.2
06532006,"Dillenburg, Stadt",06,Hessen,23510,11531,11979,2473,1769,704,2542,1856,686,10.5,7.5,3.0,10.8,7.9,2.9
06532007,Driedorf,06,Hessen,5146,2612,2534,538,359,179,898,590,308,10.5,7.0,3.5,17.5,11.5,6.0
06532008,Ehringshausen,06,Hessen,9265,4605,4660,903,616,287,527,370,157,9.7,6.6,3.1,5.7,4.0,1.7
06532009,Eschenburg,06,Hessen,10111,5178,4933,1118,802,316,1207,892,315,11.1,7.9,3.1,11.9,8.8,3.1
06532010,Greifenstein,06,Hessen,6866,3473,3393,699,475,224,563,394,169,10.2,6.9,3.3,8.2,5.7,2.5
06532011,"Haiger, Stadt",06,Hessen,19199,9498,9701,2098,1517,581,1926,1398,528,10.9,7.9,3.0,10.0,7.3,2.8
06532012,"Herborn, Stadt",06,Hessen,20816,10290,10526,2121,1478,643,2647,1829,818,10.2,7.1,3.1,12.7,8.8,3.9
06532013,Hohenahr,06,Hessen,4810,2443,2367,491,334,157,368,231,137,10.2,6.9,3.3,7.7,4.8,2.8
06532014,Hüttenberg,06,Hessen,10731,5261,5470,1075,690,385,737,498,239,10.0,6.4,3.6,6.9,4.6,2.2
06532015,Lahnau,06,Hessen,8142,3987,4155,793,525,268,573,378,195,9.7,6.4,3.3,7.0,4.6,2.4
06532016,"Leun, Stadt",06,Hessen,5862,2934,2928,552,377,175,403,259,144,9.4,6.4,3.0,6.9,4.4,2.5
06532017,Mittenaar,06,Hessen,4850,2430,2420,539,364,175,348,223,125,11.1,7.5,3.6,7.2,4.6,2.6
06532018,Schöffengrund,06,Hessen,6415,3129,3286,598,395,203,304,198,106,9.3,6.2,3.2,4.7,3.1,1.7
06532019,Siegbach,06,Hessen,2643,1317,1326,288,223,65,113,84,29,10.9,8.4,2.5,4.3,3.2,1.1
06532020,Sinn,06,Hessen,6443,3209,3234,669,437,232,467,309,158,10.4,6.8,3.6,7.2,4.8,2.5
06532021,"Solms, Stadt",06,Hessen,13456,6691,6765,1324,887,437,1001,633,368,9.8,6.6,3.2,7.4,4.7,2.7
06532022,Waldsolms,06,Hessen,4822,2464,2358,456,294,162,290,190,100,9.5,6.1,3.4,6.0,3.9,2.1
06532023,"Wetzlar, Stadt",06,Hessen,51649,24886,26763,5169,3514,1655,6779,4502,2277,10.0,6.8,3.2,13.1,8.7,4.4
06533001,Beselich,06,Hessen,5669,2821,2848,534,371,163,354,244,110,9.4,6.5,2.9,6.2,4.3,1.9
06533002,Brechen,06,Hessen,6518,3189,3329,576,395,181,425,280,145,8.8,6.1,2.8,6.5,4.3,2.2
06533003,"Bad Camberg, Stadt",06,Hessen,14031,6897,7134,1270,838,432,1148,805,343,9.1,6.0,3.1,8.2,5.7,2.4
06533004,Dornburg,06,Hessen,8527,4299,4228,882,622,260,762,566,196,10.3,7.3,3.0,8.9,6.6,2.3
06533005,Elbtal,06,Hessen,2393,1212,1181,274,171,103,137,95,42,11.5,7.1,4.3,5.7,4.0,1.8
06533006,Elz,06,Hessen,8123,3937,4186,809,567,242,768,527,241,10.0,7.0,3.0,9.5,6.5,3.0
06533007,"Hadamar, Stadt",06,Hessen,12426,6235,6191,1326,937,389,1118,773,345,10.7,7.5,3.1,9.0,6.2,2.8
06533008,Hünfelden,06,Hessen,9646,4756,4890,916,639,277,579,373,206,9.5,6.6,2.9,6.0,3.9,2.1
06533009,"Limburg a.d. Lahn, Kreisstadt",06,Hessen,34255,16834,17421,3339,2269,1070,5537,3816,1721,9.7,6.6,3.1,16.2,11.1,5.0
06533010,Löhnberg,06,Hessen,4379,2178,2201,443,298,145,322,221,101,10.1,6.8,3.3,7.4,5.0,2.3
06533011,"Mengerskirchen, Marktflecken",06,Hessen,5787,2866,2921,614,411,203,580,442,138,10.6,7.1,3.5,10.0,7.6,2.4
06533012,"Merenberg, Marktflecken",06,Hessen,3189,1590,1599,331,226,105,268,185,83,10.4,7.1,3.3,8.4,5.8,2.6
06533013,"Runkel, Stadt",06,Hessen,9561,4770,4791,974,689,285,668,447,221,10.2,7.2,3.0,7.0,4.7,2.3
06533014,Selters (Taunus),06,Hessen,8084,4086,3998,635,438,197,409,280,129,7.9,5.4,2.4,5.1,3.5,1.6
06533015,"Villmar, Marktflecken",06,Hessen,6857,3448,3409,668,469,199,489,324,165,9.7,6.8,2.9,7.1,4.7,2.4
06533016,Waldbrunn (Westerwald),06,Hessen,5882,2994,2888,572,413,159,317,231,86,9.7,7.0,2.7,5.4,3.9,1.5
06533017,"Weilburg, Stadt",06,Hessen,13337,6758,6579,1254,870,384,1657,1166,491,9.4,6.5,2.9,12.4,8.7,3.7
06533018,"Weilmünster, Marktflecken",06,Hessen,8839,4373,4466,913,575,338,682,455,227,10.3,6.5,3.8,7.7,5.1,2.6
06533019,Weinbach,06,Hessen,4419,2167,2252,457,294,163,213,148,65,10.3,6.7,3.7,4.8,3.3,1.5
06534001,"Amöneburg, Stadt",06,Hessen,5125,2565,2560,412,268,144,231,156,75,8.0,5.2,2.8,4.5,3.0,1.5
06534002,Angelburg,06,Hessen,3541,1823,1718,352,245,107,161,115,46,9.9,6.9,3.0,4.5,3.2,1.3
06534003,Bad Endbach,06,Hessen,8138,4038,4100,902,637,265,667,483,184,11.1,7.8,3.3,8.2,5.9,2.3
06534004,"Biedenkopf, Stadt",06,Hessen,13685,6781,6904,1371,946,425,1344,948,396,10.0,6.9,3.1,9.8,6.9,2.9
06534005,Breidenbach,06,Hessen,6818,3479,3339,768,534,234,648,406,242,11.3,7.8,3.4,9.5,6.0,3.5
06534006,Cölbe,06,Hessen,6799,3387,3412,574,379,195,387,279,108,8.4,5.6,2.9,5.7,4.1,1.6
06534007,Dautphetal,06,Hessen,11584,5741,5843,1246,835,411,1023,726,297,10.8,7.2,3.5,8.8,6.3,2.6
06534008,Ebsdorfergrund,06,Hessen,8900,4393,4507,794,537,257,599,398,201,8.9,6.0,2.9,6.7,4.5,2.3
06534009,Fronhausen,06,Hessen,4048,1961,2087,312,205,107,233,161,72,7.7,5.1,2.6,5.8,4.0,1.8
06534010,"Gladenbach, Stadt",06,Hessen,12166,6031,6135,1255,852,403,1415,967,448,10.3,7.0,3.3,11.6,7.9,3.7
06534011,"Kirchhain, Stadt",06,Hessen,16294,8038,8256,1451,955,496,1147,785,362,8.9,5.9,3.0,7.0,4.8,2.2
06534012,Lahntal,06,Hessen,6874,3442,3432,624,423,201,452,307,145,9.1,6.2,2.9,6.6,4.5,2.1
06534013,Lohra,06,Hessen,5465,2724,2741,577,376,201,312,200,112,10.6,6.9,3.7,5.7,3.7,2.0
06534014,"Marburg, Universitätsstadt",06,Hessen,73836,35218,38618,8089,6221,1868,10277,7627,2650,11.0,8.4,2.5,13.9,10.3,3.6
06534015,Münchhausen,06,Hessen,3429,1730,1699,300,219,81,184,127,57,8.7,6.4,2.4,5.4,3.7,1.7
06534016,"Neustadt (Hessen), Stadt",06,Hessen,9811,5124,4687,739,530,209,564,399,165,7.5,5.4,2.1,5.7,4.1,1.7
06534017,"Rauschenberg, Stadt",06,Hessen,4469,2195,2274,372,252,120,241,170,71,8.3,5.6,2.7,5.4,3.8,1.6
06534018,"Stadtallendorf, Stadt",06,Hessen,21861,10884,10977,1813,1264,549,2789,1808,981,8.3,5.8,2.5,12.8,8.3,4.5
06534019,Steffenberg,06,Hessen,4061,2053,2008,438,315,123,377,274,103,10.8,7.8,3.0,9.3,6.7,2.5
06534020,Weimar (Lahn),06,Hessen,7083,3477,3606,663,455,208,398,269,129,9.4,6.4,2.9,5.6,3.8,1.8
06534021,"Wetter (Hessen), Stadt",06,Hessen,8959,4526,4433,804,525,279,511,316,195,9.0,5.9,3.1,5.7,3.5,2.2
06534022,Wohratal,06,Hessen,2295,1165,1130,163,110,53,101,63,38,7.1,4.8,2.3,4.4,2.7,1.7
06535001,"Alsfeld, Stadt",06,Hessen,16142,7976,8166,1626,1126,500,2267,1578,689,10.1,7.0,3.1,14.0,9.8,4.3
06535002,Antrifttal,06,Hessen,1919,971,948,206,151,55,83,55,28,10.7,7.9,2.9,4.3,2.9,1.5
06535003,Feldatal,06,Hessen,2512,1271,1241,294,212,82,198,131,67,11.7,8.4,3.3,7.9,5.2,2.7
06535004,Freiensteinau,06,Hessen,3131,1546,1585,341,218,123,266,156,110,10.9,7.0,3.9,8.5,5.0,3.5
06535005,Gemünden (Felda),06,Hessen,2811,1410,1401,264,178,86,123,80,43,9.4,6.3,3.1,4.4,2.8,1.5
06535006,"Grebenau, Stadt",06,Hessen,2375,1212,1163,249,171,78,202,133,69,10.5,7.2,3.3,8.5,5.6,2.9
06535007,Grebenhain,06,Hessen,4684,2345,2339,540,332,208,463,303,160,11.5,7.1,4.4,9.9,6.5,3.4
06535008,"Herbstein, Stadt",06,Hessen,4808,2437,2371,518,335,183,1084,807,277,10.8,7.0,3.8,22.5,16.8,5.8
06535009,"Homberg (Ohm), Stadt",06,Hessen,7568,3837,3731,687,463,224,677,460,217,9.1,6.1,3.0,8.9,6.1,2.9
06535010,"Kirtorf, Stadt",06,Hessen,3222,1636,1586,298,213,85,155,109,46,9.2,6.6,2.6,4.8,3.4,1.4
06535011,"Lauterbach (Hessen), Kreisstadt",06,Hessen,14119,6998,7121,1316,885,431,1512,1056,456,9.3,6.3,3.1,10.7,7.5,3.2
06535012,Lautertal (Vogelsberg),06,Hessen,2367,1208,1159,249,163,86,97,62,35,10.5,6.9,3.6,4.1,2.6,1.5
06535013,Mücke,06,Hessen,9348,4651,4697,965,693,272,775,562,213,10.3,7.4,2.9,8.3,6.0,2.3
06535014,"Romrod, Stadt",06,Hessen,2729,1339,1390,279,190,89,261,195,66,10.2,7.0,3.3,9.6,7.1,2.4
06535015,"Schlitz, Stadt",06,Hessen,9631,4746,4885,1001,638,363,683,434,249,10.4,6.6,3.8,7.1,4.5,2.6
06535016,"Schotten, Stadt",06,Hessen,10126,5207,4919,1133,765,368,898,630,268,11.2,7.6,3.6,8.9,6.2,2.6
06535017,Schwalmtal,06,Hessen,2800,1407,1393,307,221,86,179,125,54,11.0,7.9,3.1,6.4,4.5,1.9
06535018,"Ulrichstein, Stadt",06,Hessen,3017,1524,1493,306,209,97,204,130,74,10.1,6.9,3.2,6.8,4.3,2.5
06535019,Wartenberg,06,Hessen,3947,1986,1961,415,295,120,250,170,80,10.5,7.5,3.0,6.3,4.3,2.0
06611000,"Kassel, documenta-Stadt",06,Hessen,197984,96659,101325,17974,12761,5213,22972,16222,6750,9.1,6.4,2.6,11.6,8.2,3.4
06631001,Bad Salzschlirf,06,Hessen,3271,1567,1704,289,202,87,311,224,87,8.8,6.2,2.7,9.5,6.8,2.7
06631002,"Burghaun, Marktgemeinde",06,Hessen,6387,3192,3195,737,514,223,498,353,145,11.5,8.0,3.5,7.8,5.5,2.3
06631003,Dipperz,06,Hessen,3450,1713,1737,368,246,122,239,142,97,10.7,7.1,3.5,6.9,4.1,2.8
06631004,Ebersburg,06,Hessen,4554,2302,2252,523,362,161,268,176,92,11.5,7.9,3.5,5.9,3.9,2.0
06631005,Ehrenberg (Rhön),06,Hessen,2688,1382,1306,283,181,102,148,102,46,10.5,6.7,3.8,5.5,3.8,1.7
06631006,Eichenzell,06,Hessen,11019,5497,5522,1280,826,454,1011,664,347,11.6,7.5,4.1,9.2,6.0,3.1
06631007,"Eiterfeld, Marktgemeinde",06,Hessen,7023,3488,3535,795,578,217,599,437,162,11.3,8.2,3.1,8.5,6.2,2.3
06631008,Flieden,06,Hessen,8758,4399,4359,1026,732,294,679,475,204,11.7,8.4,3.4,7.8,5.4,2.3
06631009,"Fulda, Stadt",06,Hessen,67253,32917,34336,7080,4856,2224,11346,7700,3646,10.5,7.2,3.3,16.9,11.4,5.4
06631010,"Gersfeld (Rhön), Stadt",06,Hessen,5506,2714,2792,625,392,233,576,376,200,11.4,7.1,4.2,10.5,6.8,3.6
06631011,Großenlüder,06,Hessen,8692,4344,4348,977,659,318,721,502,219,11.2,7.6,3.7,8.3,5.8,2.5
06631012,Hilders,06,Hessen,4757,2420,2337,479,325,154,429,283,146,10.1,6.8,3.2,9.0,5.9,3.1
06631013,Hofbieber,06,Hessen,5985,3046,2939,650,457,193,556,380,176,10.9,7.6,3.2,9.3,6.3,2.9
06631014,Hosenfeld,06,Hessen,4629,2327,2302,495,328,167,263,165,98,10.7,7.1,3.6,5.7,3.6,2.1
06631015,"Hünfeld, Konrad-Zuse-Stadt",06,Hessen,15996,7974,8022,1619,1097,522,1567,1055,512,10.1,6.9,3.3,9.8,6.6,3.2
06631016,Kalbach,06,Hessen,6264,3173,3091,768,504,264,645,394,251,12.3,8.0,4.2,10.3,6.3,4.0
06631017,Künzell,06,Hessen,16322,7847,8475,1667,1093,574,1224,823,401,10.2,6.7,3.5,7.5,5.0,2.5
06631018,Neuhof,06,Hessen,10838,5416,5422,1116,765,351,857,587,270,10.3,7.1,3.2,7.9,5.4,2.5
06631019,Nüsttal,06,Hessen,2801,1446,1355,320,202,118,116,75,41,11.4,7.2,4.2,4.1,2.7,1.5
06631020,Petersberg,06,Hessen,15344,7472,7872,1388,922,466,1053,736,317,9.0,6.0,3.0,6.9,4.8,2.1
06631021,Poppenhausen (Wasserkuppe),06,Hessen,2569,1294,1275,289,193,96,367,263,104,11.2,7.5,3.7,14.3,10.2,4.0
06631022,"Rasdorf, Point-Alpha-Gemeinde",06,Hessen,1640,846,794,167,119,48,92,68,24,10.2,7.3,2.9,5.6,4.1,1.5
06631023,"Tann (Rhön), Stadt",06,Hessen,4386,2217,2169,378,266,112,314,235,79,8.6,6.1,2.6,7.2,5.4,1.8
06632001,Alheim,06,Hessen,4985,2506,2479,419,308,111,293,218,75,8.4,6.2,2.2,5.9,4.4,1.5
06632002,"Bad Hersfeld, Kreisstadt",06,Hessen,29116,14179,14937,2559,1742,817,3558,2475,1083,8.8,6.0,2.8,12.2,8.5,3.7
06632003,"Bebra, Stadt",06,Hessen,13888,6846,7042,1085,836,249,1004,785,219,7.8,6.0,1.8,7.2,5.7,1.6
06632004,Breitenbach a. Herzberg,06,Hessen,1754,955,799,168,115,53,109,82,27,9.6,6.6,3.0,6.2,4.7,1.5
06632005,Cornberg,06,Hessen,1407,729,678,116,87,29,45,32,13,8.2,6.2,2.1,3.2,2.3,0.9
06632006,Friedewald,06,Hessen,2420,1242,1178,218,165,53,211,161,50,9.0,6.8,2.2,8.7,6.7,2.1
06632007,Hauneck,06,Hessen,3175,1605,1570,281,206,75,290,226,64,8.9,6.5,2.4,9.1,7.1,2.0
06632008,Haunetal,06,Hessen,2943,1536,1407,278,194,84,155,107,48,9.4,6.6,2.9,5.3,3.6,1.6
06632009,"Heringen (Werra), Stadt",06,Hessen,7294,3585,3709,592,436,156,463,334,129,8.1,6.0,2.1,6.3,4.6,1.8
06632010,Hohenroda,06,Hessen,3114,1581,1533,324,248,76,210,155,55,10.4,8.0,2.4,6.7,5.0,1.8
06632011,Kirchheim,06,Hessen,4093,2189,1904,392,261,131,361,231,130,9.6,6.4,3.2,8.8,5.6,3.2
06632012,Ludwigsau,06,Hessen,5530,2710,2820,463,334,129,199,131,68,8.4,6.0,2.3,3.6,2.4,1.2
06632013,Nentershausen,06,Hessen,2678,1313,1365,211,157,54,153,110,43,7.9,5.9,2.0,5.7,4.1,1.6
06632014,Neuenstein,06,Hessen,3016,1562,1454,301,210,91,221,143,78,10.0,7.0,3.0,7.3,4.7,2.6
06632015,"Niederaula, Marktgemeinde",06,Hessen,5377,2683,2694,483,332,151,496,328,168,9.0,6.2,2.8,9.2,6.1,3.1
06632016,"Philippsthal (Werra), Marktgemeinde",06,Hessen,4156,2110,2046,351,271,80,273,208,65,8.4,6.5,1.9,6.6,5.0,1.6
06632017,Ronshausen,06,Hessen,2336,1179,1157,166,121,45,138,105,33,7.1,5.2,1.9,5.9,4.5,1.4
06632018,"Rotenburg a. d. Fulda, Stadt",06,Hessen,14411,7173,7238,1042,731,311,1017,725,292,7.2,5.1,2.2,7.1,5.0,2.0
06632019,Schenklengsfeld,06,Hessen,4527,2282,2245,459,327,132,331,237,94,10.1,7.2,2.9,7.3,5.2,2.1
06632020,Wildeck,06,Hessen,4946,2442,2504,372,263,109,288,212,76,7.5,5.3,2.2,5.8,4.3,1.5
06633001,Ahnatal,06,Hessen,7893,3895,3998,613,429,184,401,282,119,7.8,5.4,2.3,5.1,3.6,1.5
06633002,"Bad Karlshafen, Stadt",06,Hessen,3718,1878,1840,344,251,93,385,284,101,9.3,6.8,2.5,10.4,7.6,2.7
06633003,"Baunatal, Stadt",06,Hessen,27617,13372,14245,2311,1621,690,2411,1605,806,8.4,5.9,2.5,8.7,5.8,2.9
06633004,Breuna,06,Hessen,3590,1800,1790,309,231,78,196,156,40,8.6,6.4,2.2,5.5,4.3,1.1
06633005,Calden,06,Hessen,8061,4199,3862,629,433,196,443,290,153,7.8,5.4,2.4,5.5,3.6,1.9
06633006,Bad Emstal,06,Hessen,5960,2951,3009,488,339,149,458,306,152,8.2,5.7,2.5,7.7,5.1,2.6
06633007,Espenau,06,Hessen,5070,2492,2578,392,261,131,314,202,112,7.7,5.1,2.6,6.2,4.0,2.2
06633008,Fuldabrück,06,Hessen,8692,4245,4447,720,503,217,748,509,239,8.3,5.8,2.5,8.6,5.9,2.7
06633009,Fuldatal,06,Hessen,12395,6221,6174,1053,761,292,789,555,234,8.5,6.1,2.4,6.4,4.5,1.9
06633010,"Grebenstein, Stadt",06,Hessen,5808,2878,2930,452,337,115,323,242,81,7.8,5.8,2.0,5.6,4.2,1.4
06633011,Habichtswald,06,Hessen,4974,2460,2514,412,296,116,268,181,87,8.3,6.0,2.3,5.4,3.6,1.7
06633012,Helsa,06,Hessen,5570,2719,2851,426,295,131,224,161,63,7.6,5.3,2.4,4.0,2.9,1.1
06633013,"Hofgeismar, Stadt",06,Hessen,14872,7164,7708,1351,912,439,1644,1154,490,9.1,6.1,3.0,11.1,7.8,3.3
06633014,"Immenhausen, Stadt",06,Hessen,6868,3385,3483,586,405,181,434,303,131,8.5,5.9,2.6,6.3,4.4,1.9
06633015,Kaufungen,06,Hessen,12406,5978,6428,1099,721,378,949,662,287,8.9,5.8,3.0,7.6,5.3,2.3
06633016,"Liebenau, Stadt",06,Hessen,3123,1508,1615,296,213,83,160,106,54,9.5,6.8,2.7,5.1,3.4,1.7
06633017,Lohfelden,06,Hessen,13591,6645,6946,1318,898,420,1209,807,402,9.7,6.6,3.1,8.9,5.9,3.0
06633018,"Naumburg, Stadt",06,Hessen,5085,2509,2576,407,285,122,306,214,92,8.0,5.6,2.4,6.0,4.2,1.8
06633019,Nieste,06,Hessen,1929,958,971,158,107,51,94,68,26,8.2,5.5,2.6,4.9,3.5,1.3
06633020,Niestetal,06,Hessen,10940,5350,5590,928,593,335,1054,714,340,8.5,5.4,3.1,9.6,6.5,3.1
06633021,Oberweser,06,Hessen,3269,1674,1595,341,229,112,209,138,71,10.4,7.0,3.4,6.4,4.2,2.2
06633022,Reinhardshagen,06,Hessen,4491,2227,2264,379,253,126,262,168,94,8.4,5.6,2.8,5.8,3.7,2.1
06633023,Schauenburg,06,Hessen,10140,5084,5056,823,588,235,498,364,134,8.1,5.8,2.3,4.9,3.6,1.3
06633024,Söhrewald,06,Hessen,4748,2353,2395,385,271,114,201,130,71,8.1,5.7,2.4,4.2,2.7,1.5
06633025,"Trendelburg, Stadt",06,Hessen,5087,2526,2561,390,277,113,273,193,80,7.7,5.4,2.2,5.4,3.8,1.6
06633026,"Vellmar, Stadt",06,Hessen,18033,8500,9533,1532,1048,484,1170,851,319,8.5,5.8,2.7,6.5,4.7,1.8
06633027,Wahlsburg,06,Hessen,2039,1003,1036,176,128,48,172,129,43,8.6,6.3,2.4,8.4,6.3,2.1
06633028,"Wolfhagen, Stadt",06,Hessen,13276,6767,6509,1208,795,413,1112,744,368,9.1,6.0,3.1,8.4,5.6,2.8
06633029,"Zierenberg, Stadt",06,Hessen,6568,3231,3337,532,372,160,422,277,145,8.1,5.7,2.4,6.4,4.2,2.2
06634001,"Borken (Hessen), Stadt",06,Hessen,12633,6329,6304,1076,788,288,771,556,215,8.5,6.2,2.3,6.1,4.4,1.7
06634002,Edermünde,06,Hessen,7218,3604,3614,557,380,177,618,471,147,7.7,5.3,2.5,8.6,6.5,2.0
06634003,"Felsberg, Stadt",06,Hessen,10624,5204,5420,884,642,242,563,397,166,8.3,6.0,2.3,5.3,3.7,1.6
06634004,Frielendorf,06,Hessen,7296,3653,3643,719,522,197,537,390,147,9.9,7.2,2.7,7.4,5.3,2.0
06634005,"Fritzlar, Dom- und Kaiserstadt",06,Hessen,14428,7100,7328,1380,969,411,1781,1270,511,9.6,6.7,2.8,12.3,8.8,3.5
06634006,Gilserberg,06,Hessen,3063,1561,1502,254,167,87,181,134,47,8.3,5.5,2.8,5.9,4.4,1.5
06634007,"Gudensberg, Stadt",06,Hessen,9532,4714,4818,773,513,260,773,529,244,8.1,5.4,2.7,8.1,5.5,2.6
06634008,Guxhagen,06,Hessen,5309,2630,2679,450,309,141,588,392,196,8.5,5.8,2.7,11.1,7.4,3.7
06634009,"Homberg (Efze), Reformationsstadt, Kreisstadt",06,Hessen,13907,6897,7010,1342,964,378,1233,867,366,9.6,6.9,2.7,8.9,6.2,2.6
06634010,Jesberg,06,Hessen,2347,1183,1164,190,144,46,119,98,21,8.1,6.1,2.0,5.1,4.2,0.9
06634011,Knüllwald,06,Hessen,4508,2270,2238,389,275,114,325,245,80,8.6,6.1,2.5,7.2,5.4,1.8
06634012,Körle,06,Hessen,2911,1471,1440,229,167,62,209,142,67,7.9,5.7,2.1,7.2,4.9,2.3
06634013,Malsfeld,06,Hessen,3964,1993,1971,332,212,120,431,242,189,8.4,5.3,3.0,10.9,6.1,4.8
06634014,"Melsungen, Stadt",06,Hessen,13381,6576,6805,1093,780,313,1204,865,339,8.2,5.8,2.3,9.0,6.5,2.5
06634015,Morschen,06,Hessen,3333,1693,1640,279,225,54,190,153,37,8.4,6.8,1.6,5.7,4.6,1.1
06634016,Neuental,06,Hessen,3162,1593,1569,273,205,68,144,116,28,8.6,6.5,2.2,4.6,3.7,0.9
06634017,"Neukirchen, Stadt",06,Hessen,7174,3644,3530,644,463,181,613,453,160,9.0,6.5,2.5,8.5,6.3,2.2
06634018,"Niedenstein, Stadt",06,Hessen,5311,2707,2604,380,265,115,201,135,66,7.2,5.0,2.2,3.8,2.5,1.2
06634019,Oberaula,06,Hessen,3169,1596,1573,302,216,86,233,169,64,9.5,6.8,2.7,7.4,5.3,2.0
06634020,Ottrau,06,Hessen,2242,1104,1138,191,126,65,334,213,121,8.5,5.6,2.9,14.9,9.5,5.4
06634021,Schrecksbach,06,Hessen,3104,1516,1588,244,178,66,150,111,39,7.9,5.7,2.1,4.8,3.6,1.3
06634022,"Schwalmstadt, Stadt",06,Hessen,17861,9024,8837,1399,971,428,1820,1236,584,7.8,5.4,2.4,10.2,6.9,3.3
06634023,"Schwarzenborn, Stadt",06,Hessen,1408,848,560,88,66,22,87,56,31,6.2,4.7,1.6,6.2,4.0,2.2
06634024,"Spangenberg, Liebenbachstadt",06,Hessen,6329,3266,3063,471,333,138,416,298,118,7.4,5.3,2.2,6.6,4.7,1.9
06634025,Wabern,06,Hessen,7326,3712,3614,637,441,196,449,316,133,8.7,6.0,2.7,6.1,4.3,1.8
06634026,Willingshausen,06,Hessen,4872,2452,2420,411,283,128,248,178,70,8.4,5.8,2.6,5.1,3.7,1.4
06634027,Bad Zwesten,06,Hessen,3898,1889,2009,399,257,142,363,228,135,10.2,6.6,3.6,9.3,5.8,3.5
06635001,Allendorf (Eder),06,Hessen,5665,2835,2830,508,352,156,348,271,77,9.0,6.2,2.8,6.1,4.8,1.4
06635002,"Bad Arolsen, Stadt",06,Hessen,15507,7617,7890,1581,1024,557,1703,1132,571,10.2,6.6,3.6,11.0,7.3,3.7
06635003,"Bad Wildungen, Stadt",06,Hessen,16777,8239,8538,1724,1058,666,1879,1170,709,10.3,6.3,4.0,11.2,7.0,4.2
06635004,"Battenberg (Eder), Stadt",06,Hessen,5414,2723,2691,504,350,154,570,400,170,9.3,6.5,2.8,10.5,7.4,3.1
06635005,Bromskirchen,06,Hessen,1838,964,874,182,123,59,112,71,41,9.9,6.7,3.2,6.1,3.9,2.2
06635006,Burgwald,06,Hessen,4863,2448,2415,438,289,149,363,250,113,9.0,5.9,3.1,7.5,5.1,2.3
06635007,Diemelsee,06,Hessen,4831,2465,2366,470,319,151,322,214,108,9.7,6.6,3.1,6.7,4.4,2.2
06635008,"Diemelstadt, Stadt",06,Hessen,5250,2665,2585,492,320,172,367,234,133,9.4,6.1,3.3,7.0,4.5,2.5
06635009,Edertal,06,Hessen,6292,3144,3148,598,391,207,389,252,137,9.5,6.2,3.3,6.2,4.0,2.2
06635010,"Frankenau, Stadt",06,Hessen,2919,1472,1447,244,161,83,148,100,48,8.4,5.5,2.8,5.1,3.4,1.6
06635011,"Frankenberg (Eder), Stadt",06,Hessen,17855,8852,9003,1760,1195,565,1791,1242,549,9.9,6.7,3.2,10.0,7.0,3.1
06635012,"Gemünden (Wohra), Stadt",06,Hessen,4127,2120,2007,343,229,114,366,215,151,8.3,5.5,2.8,8.9,5.2,3.7
06635013,Haina (Kloster),06,Hessen,3581,1944,1637,302,181,121,180,120,60,8.4,5.1,3.4,5.0,3.4,1.7
06635014,"Hatzfeld (Eder), Stadt",06,Hessen,3029,1551,1478,312,219,93,239,179,60,10.3,7.2,3.1,7.9,5.9,2.0
06635015,"Korbach, Hansestadt",06,Hessen,23515,11447,12068,2383,1566,817,2944,1887,1057,10.1,6.7,3.5,12.5,8.0,4.5
06635016,"Lichtenfels, Stadt",06,Hessen,4181,2143,2038,375,258,117,252,168,84,9.0,6.2,2.8,6.0,4.0,2.0
06635017,"Rosenthal, Stadt",06,Hessen,2213,1119,1094,179,122,57,113,83,30,8.1,5.5,2.6,5.1,3.8,1.4
06635018,Twistetal,06,Hessen,4424,2263,2161,465,321,144,264,174,90,10.5,7.3,3.3,6.0,3.9,2.0
06635019,Vöhl,06,Hessen,5616,2786,2830,504,346,158,324,214,110,9.0,6.2,2.8,5.8,3.8,2.0
06635020,"Volkmarsen, Stadt",06,Hessen,6867,3436,3431,637,432,205,518,346,172,9.3,6.3,3.0,7.5,5.0,2.5
06635021,"Waldeck, Stadt",06,Hessen,6758,3369,3389,635,421,214,552,371,181,9.4,6.2,3.2,8.2,5.5,2.7
06635022,Willingen (Upland),06,Hessen,6070,3053,3017,847,503,344,1358,777,581,14.0,8.3,5.7,22.4,12.8,9.6
06636001,"Bad Sooden-Allendorf, Stadt",06,Hessen,8463,4143,4320,740,526,214,696,504,192,8.7,6.2,2.5,8.2,6.0,2.3
06636002,Berkatal,06,Hessen,1560,752,808,164,112,52,114,79,35,10.5,7.2,3.3,7.3,5.1,2.2
06636003,"Eschwege, Kreisstadt",06,Hessen,19542,9388,10154,1570,1135,435,1913,1359,554,8.0,5.8,2.2,9.8,7.0,2.8
06636004,"Großalmerode, Stadt",06,Hessen,6469,3165,3304,579,419,160,389,272,117,9.0,6.5,2.5,6.0,4.2,1.8
06636005,Herleshausen,06,Hessen,2816,1471,1345,212,166,46,211,151,60,7.5,5.9,1.6,7.5,5.4,2.1
06636006,"Hessisch Lichtenau, Stadt",06,Hessen,12100,6093,6007,979,688,291,986,698,288,8.1,5.7,2.4,8.1,5.8,2.4
06636007,Meinhard,06,Hessen,4716,2327,2389,357,251,106,273,214,59,7.6,5.3,2.2,5.8,4.5,1.3
06636008,Meißner,06,Hessen,3055,1509,1546,250,188,62,136,97,39,8.2,6.2,2.0,4.5,3.2,1.3
06636009,Neu-Eichenberg,06,Hessen,1848,896,952,128,83,45,90,60,30,6.9,4.5,2.4,4.9,3.2,1.6
06636010,Ringgau,06,Hessen,2974,1510,1464,239,183,56,180,136,44,8.0,6.2,1.9,6.1,4.6,1.5
06636011,"Sontra, Stadt",06,Hessen,7629,3840,3789,677,518,159,491,395,96,8.9,6.8,2.1,6.4,5.2,1.3
06636012,"Waldkappel, Stadt",06,Hessen,4411,2204,2207,374,269,105,292,218,74,8.5,6.1,2.4,6.6,4.9,1.7
06636013,"Wanfried, Stadt",06,Hessen,4131,2043,2088,321,244,77,265,207,58,7.8,5.9,1.9,6.4,5.0,1.4
06636014,Wehretal,06,Hessen,5015,2470,2545,392,293,99,260,211,49,7.8,5.8,2.0,5.2,4.2,1.0
06636015,Weißenborn,06,Hessen,1037,528,509,81,62,19,38,30,8,7.8,6.0,1.8,3.7,2.9,0.8
06636016,"Witzenhausen, Stadt",06,Hessen,14949,7243,7706,1292,964,328,1279,943,336,8.6,6.4,2.2,8.6,6.3,2.2
