ags,name,bundesland_id,bundesland,bevoelkerung_total,bevoelkerung_maennlich,bevoelkerung_weiblich,mj_wohnort_insgesamt,mj_wohnort_ausschliesslich,mj_wohnort_nebenjob,mj_arbeitsort_insgesamt,mj_arbeitsort_ausschliesslich,mj_arbeitsort_nebenjob,mj_wohnort_insgesamt_prozent,mj_wohnort_ausschliesslich_prozent,mj_wohnort_nebenjob_prozent,mj_arbeitsort_insgesamt_prozent,mj_arbeitsort_ausschliesslich_prozent,mj_arbeitsort_nebenjob_prozent
03101000,"Braunschweig, Stadt",03,Niedersachsen,251364,125001,126363,20719,14464,6255,23903,16682,7221,8.2,5.8,2.5,9.5,6.6,2.9
03102000,"Salzgitter, Stadt",03,Niedersachsen,101079,49898,51181,7687,5606,2081,6652,4796,1856,7.6,5.5,2.1,6.6,4.7,1.8
03103000,"Wolfsburg, Stadt",03,Niedersachsen,124045,61581,62464,9075,6364,2711,10580,7217,3363,7.3,5.1,2.2,8.5,5.8,2.7
03151009,"Gifhorn, Stadt",03,Niedersachsen,41905,20661,21244,3424,2452,972,3911,2872,1039,8.2,5.9,2.3,9.3,6.9,2.5
03151025,Sassenburg,03,Niedersachsen,11358,5707,5651,830,615,215,397,290,107,7.3,5.4,1.9,3.5,2.6,0.9
03151040,"Wittingen, Stadt",03,Niedersachsen,11480,5765,5715,886,626,260,707,499,208,7.7,5.5,2.3,6.2,4.3,1.8
03151002,Barwedel,03,Niedersachsen,1000,522,478,77,51,26,16,12,4,7.7,5.1,2.6,1.6,1.2,0.4
03151004,Bokensdorf,03,Niedersachsen,1185,582,603,79,53,26,28,23,5,6.7,4.5,2.2,2.4,1.9,0.4
03151014,Jembke,03,Niedersachsen,1965,963,1002,147,96,51,80,49,31,7.5,4.9,2.6,4.1,2.5,1.6
03151020,Osloß,03,Niedersachsen,1927,977,950,117,84,33,31,25,6,6.1,4.4,1.7,1.6,1.3,0.3
03151030,Tappenbeck,03,Niedersachsen,1390,674,716,89,64,25,-1,-1,-1,6.4,4.6,1.8,-0.1,,
03151039,Weyhausen,03,Niedersachsen,2443,1200,1243,182,133,49,203,163,40,7.4,5.4,2.0,8.3,6.7,1.6
03151003,Bergfeld,03,Niedersachsen,886,443,443,65,45,20,-1,-1,-1,7.3,5.1,2.3,-0.1,,
03151005,"Brome, Flecken",03,Niedersachsen,3209,1620,1589,244,186,58,229,179,50,7.6,5.8,1.8,7.1,5.6,1.6
03151008,Ehra-Lessien,03,Niedersachsen,2291,1298,993,102,74,28,42,29,13,4.5,3.2,1.2,1.8,1.3,0.6
03151021,Parsau,03,Niedersachsen,1860,952,908,132,96,36,102,78,24,7.1,5.2,1.9,5.5,4.2,1.3
03151024,Rühen,03,Niedersachsen,5488,2802,2686,337,252,85,185,135,50,6.1,4.6,1.5,3.4,2.5,0.9
03151031,Tiddische,03,Niedersachsen,1256,640,616,75,59,16,38,24,14,6.0,4.7,1.3,3.0,1.9,1.1
03151032,Tülau,03,Niedersachsen,1480,749,731,88,65,23,35,22,13,5.9,4.4,1.6,2.4,1.5,0.9
03151007,Dedelstorf,03,Niedersachsen,1248,625,623,107,73,34,43,24,19,8.6,5.8,2.7,3.4,1.9,1.5
03151011,Hankensbüttel,03,Niedersachsen,4385,2178,2207,436,297,139,420,292,128,9.9,6.8,3.2,9.6,6.7,2.9
03151019,Obernholz,03,Niedersachsen,889,453,436,87,57,30,77,54,23,9.8,6.4,3.4,8.7,6.1,2.6
03151028,Sprakensehl,03,Niedersachsen,1242,636,606,92,67,25,69,55,14,7.4,5.4,2.0,5.6,4.4,1.1
03151029,Steinhorst,03,Niedersachsen,1276,636,640,119,84,35,71,62,9,9.3,6.6,2.7,5.6,4.9,0.7
03151006,Calberlah,03,Niedersachsen,4967,2484,2483,356,259,97,173,116,57,7.2,5.2,2.0,3.5,2.3,1.1
03151013,Isenbüttel,03,Niedersachsen,6416,3291,3125,472,326,146,565,409,156,7.4,5.1,2.3,8.8,6.4,2.4
03151022,Ribbesbüttel,03,Niedersachsen,2015,1030,985,152,110,42,55,42,13,7.5,5.5,2.1,2.7,2.1,0.6
03151037,Wasbüttel,03,Niedersachsen,1889,943,946,150,111,39,49,37,12,7.9,5.9,2.1,2.6,2.0,0.6
03151012,Hillerse,03,Niedersachsen,2473,1222,1251,181,127,54,81,50,31,7.3,5.1,2.2,3.3,2.0,1.3
03151015,Leiferde,03,Niedersachsen,4339,2163,2176,354,262,92,239,169,70,8.2,6.0,2.1,5.5,3.9,1.6
03151017,Meinersen,03,Niedersachsen,8147,4064,4083,668,459,209,520,354,166,8.2,5.6,2.6,6.4,4.3,2.0
03151018,Müden (Aller),03,Niedersachsen,5421,2719,2702,484,336,148,332,220,112,8.9,6.2,2.7,6.1,4.1,2.1
03151001,Adenbüttel,03,Niedersachsen,1734,880,854,131,95,36,90,69,21,7.6,5.5,2.1,5.2,4.0,1.2
03151016,Meine,03,Niedersachsen,8556,4196,4360,620,453,167,559,437,122,7.2,5.3,2.0,6.5,5.1,1.4
03151023,Rötgesbüttel,03,Niedersachsen,2241,1142,1099,176,131,45,65,48,17,7.9,5.8,2.0,2.9,2.1,0.8
03151027,Schwülper,03,Niedersachsen,7127,3474,3653,481,327,154,418,272,146,6.7,4.6,2.2,5.9,3.8,2.0
03151034,Vordorf,03,Niedersachsen,3023,1536,1487,234,148,86,148,100,48,7.7,4.9,2.8,4.9,3.3,1.6
03151041,Didderse,03,Niedersachsen,1311,657,654,101,65,36,74,48,26,7.7,5.0,2.7,5.6,3.7,2.0
03151010,Groß Oesingen,03,Niedersachsen,1871,962,909,179,124,55,130,99,31,9.6,6.6,2.9,6.9,5.3,1.7
03151026,Schönewörde,03,Niedersachsen,912,454,458,70,48,22,49,44,5,7.7,5.3,2.4,5.4,4.8,0.5
03151033,Ummern,03,Niedersachsen,1582,817,765,142,95,47,60,39,21,9.0,6.0,3.0,3.8,2.5,1.3
03151035,Wagenhoff,03,Niedersachsen,1181,601,580,94,67,27,-1,-1,-1,8.0,5.7,2.3,-0.1,,
03151036,Wahrenholz,03,Niedersachsen,3624,1824,1800,306,204,102,271,203,68,8.4,5.6,2.8,7.5,5.6,1.9
03151038,Wesendorf,03,Niedersachsen,5213,2587,2626,455,334,121,357,243,114,8.7,6.4,2.3,6.8,4.7,2.2
03152001,"Adelebsen, Flecken",03,Niedersachsen,6573,3292,3281,506,323,183,362,256,106,7.7,4.9,2.8,5.5,3.9,1.6
03152004,"Bovenden, Flecken",03,Niedersachsen,13510,6611,6899,1186,751,435,672,430,242,8.8,5.6,3.2,5.0,3.2,1.8
03152007,"Duderstadt, Stadt",03,Niedersachsen,21072,10393,10679,1794,1263,531,1747,1229,518,8.5,6.0,2.5,8.3,5.8,2.5
03152009,Friedland,03,Niedersachsen,12506,6864,5642,601,358,243,362,222,140,4.8,2.9,1.9,2.9,1.8,1.1
03152011,Gleichen,03,Niedersachsen,8984,4478,4506,748,470,278,425,276,149,8.3,5.2,3.1,4.7,3.1,1.7
03152012,"Göttingen, Stadt",03,Niedersachsen,118914,57732,61182,12239,9063,3176,14763,10709,4054,10.3,7.6,2.7,12.4,9.0,3.4
03152016,"Hann. Münden, Stadt",03,Niedersachsen,24072,11920,12152,2155,1402,753,2228,1497,731,9.0,5.8,3.1,9.3,6.2,3.0
03152021,Rosdorf,03,Niedersachsen,11909,5930,5979,1106,689,417,864,557,307,9.3,5.8,3.5,7.3,4.7,2.6
03152026,Staufenberg,03,Niedersachsen,7800,3855,3945,676,446,230,351,246,105,8.7,5.7,2.9,4.5,3.2,1.3
03152005,Bühren,03,Niedersachsen,528,261,267,53,40,13,10,6,4,10.0,7.6,2.5,1.9,1.1,0.8
03152006,"Dransfeld, Stadt",03,Niedersachsen,4345,2115,2230,435,288,147,435,309,126,10.0,6.6,3.4,10.0,7.1,2.9
03152013,Jühnde,03,Niedersachsen,1018,513,505,103,62,41,71,45,26,10.1,6.1,4.0,7.0,4.4,2.6
03152017,Niemetal,03,Niedersachsen,1499,740,759,137,91,46,60,36,24,9.1,6.1,3.1,4.0,2.4,1.6
03152023,Scheden,03,Niedersachsen,1926,989,937,147,89,58,86,49,37,7.6,4.6,3.0,4.5,2.5,1.9
03152002,Bilshausen,03,Niedersachsen,2217,1127,1090,196,137,59,147,109,38,8.8,6.2,2.7,6.6,4.9,1.7
03152003,Bodensee,03,Niedersachsen,821,418,403,65,42,23,30,18,12,7.9,5.1,2.8,3.7,2.2,1.5
03152010,"Gieboldehausen, Flecken",03,Niedersachsen,4132,2005,2127,369,252,117,302,232,70,8.9,6.1,2.8,7.3,5.6,1.7
03152014,Krebeck,03,Niedersachsen,1077,541,536,86,59,27,44,27,17,8.0,5.5,2.5,4.1,2.5,1.6
03152018,Obernfeld,03,Niedersachsen,951,481,470,70,52,18,20,15,5,7.4,5.5,1.9,2.1,1.6,0.5
03152019,Rhumspringe,03,Niedersachsen,1822,939,883,126,90,36,102,77,25,6.9,4.9,2.0,5.6,4.2,1.4
03152020,Rollshausen,03,Niedersachsen,827,425,402,65,45,20,63,48,15,7.9,5.4,2.4,7.6,5.8,1.8
03152022,Rüdershausen,03,Niedersachsen,847,411,436,74,56,18,31,19,12,8.7,6.6,2.1,3.7,2.2,1.4
03152028,Wollbrandshausen,03,Niedersachsen,622,309,313,42,27,15,21,15,6,6.8,4.3,2.4,3.4,2.4,1.0
03152029,Wollershausen,03,Niedersachsen,519,274,245,46,32,14,18,12,6,8.9,6.2,2.7,3.5,2.3,1.2
03152008,Ebergötzen,03,Niedersachsen,1918,914,1004,158,105,53,310,228,82,8.2,5.5,2.8,16.2,11.9,4.3
03152015,Landolfshausen,03,Niedersachsen,1040,510,530,92,61,31,68,44,24,8.8,5.9,3.0,6.5,4.2,2.3
03152024,Seeburg,03,Niedersachsen,1585,799,786,151,101,50,85,68,17,9.5,6.4,3.2,5.4,4.3,1.1
03152025,Seulingen,03,Niedersachsen,1337,666,671,126,83,43,92,62,30,9.4,6.2,3.2,6.9,4.6,2.2
03152027,Waake,03,Niedersachsen,1282,630,652,71,40,31,41,26,15,5.5,3.1,2.4,3.2,2.0,1.2
03153002,"Bad Harzburg, Stadt",03,Niedersachsen,21735,10099,11636,1745,1268,477,1499,1087,412,8.0,5.8,2.2,6.9,5.0,1.9
03153007,"Langelsheim, Stadt",03,Niedersachsen,11697,5833,5864,982,749,233,658,486,172,8.4,6.4,2.0,5.6,4.2,1.5
03153008,Liebenburg,03,Niedersachsen,8059,4036,4023,589,402,187,333,229,104,7.3,5.0,2.3,4.1,2.8,1.3
03153012,"Seesen, Stadt",03,Niedersachsen,19296,9367,9929,1644,1182,462,1689,1177,512,8.5,6.1,2.4,8.8,6.1,2.7
03153016,"Braunlage, Stadt",03,Niedersachsen,6803,3500,3303,614,435,179,633,436,197,9.0,6.4,2.6,9.3,6.4,2.9
03153017,"Goslar, Stadt",03,Niedersachsen,50782,24582,26200,4338,3113,1225,4938,3470,1468,8.5,6.1,2.4,9.7,6.8,2.9
03153018,"Clausthal-Zellerfeld, Berg- und Universitätsstadt",03,Niedersachsen,15818,8826,6992,1717,1265,452,1452,1081,371,10.9,8.0,2.9,9.2,6.8,2.3
03153006,Hahausen,03,Niedersachsen,792,404,388,64,50,14,20,17,3,8.1,6.3,1.8,2.5,2.1,0.4
03153009,"Lutter am Barenberge, Flecken",03,Niedersachsen,2357,1151,1206,188,142,46,115,84,31,8.0,6.0,2.0,4.9,3.6,1.3
03153014,Wallmoden,03,Niedersachsen,897,447,450,60,42,18,33,23,10,6.7,4.7,2.0,3.7,2.6,1.1
03154003,Büddenstedt,03,Niedersachsen,2485,1223,1262,159,121,38,66,52,14,6.4,4.9,1.5,2.7,2.1,0.6
03154010,"Helmstedt, Stadt",03,Niedersachsen,23254,11318,11936,1739,1292,447,2208,1602,606,7.5,5.6,1.9,9.5,6.9,2.6
03154013,"Königslutter am Elm, Stadt",03,Niedersachsen,15733,7775,7958,1073,799,274,794,606,188,6.8,5.1,1.7,5.0,3.9,1.2
03154014,Lehre,03,Niedersachsen,11927,6029,5898,873,623,250,549,368,181,7.3,5.2,2.1,4.6,3.1,1.5
03154019,"Schöningen, Stadt",03,Niedersachsen,11430,5684,5746,768,605,163,602,480,122,6.7,5.3,1.4,5.3,4.2,1.1
03154008,Grasleben,03,Niedersachsen,2470,1190,1280,174,137,37,156,138,18,7.0,5.5,1.5,6.3,5.6,0.7
03154015,Mariental,03,Niedersachsen,836,411,425,62,47,15,-1,-1,-1,7.4,5.6,1.8,-0.1,,
03154016,Querenhorst,03,Niedersachsen,492,254,238,39,29,10,7,-1,-1,7.9,5.9,2.0,1.4,,
03154018,Rennau,03,Niedersachsen,688,337,351,47,36,11,35,23,12,6.8,5.2,1.6,5.1,3.3,1.7
03154002,Beierstedt,03,Niedersachsen,387,189,198,22,17,5,-1,-1,-1,5.7,4.4,1.3,-0.3,,
03154006,Gevensleben,03,Niedersachsen,638,319,319,57,45,12,45,37,8,8.9,7.1,1.9,7.1,5.8,1.3
03154011,Ingeleben,03,Niedersachsen,373,176,197,35,23,12,10,-1,-1,9.4,6.2,3.2,2.7,,
03154012,Jerxheim,03,Niedersachsen,1223,579,644,84,68,16,77,66,11,6.9,5.6,1.3,6.3,5.4,0.9
03154020,Söllingen,03,Niedersachsen,633,319,314,41,33,8,56,28,28,6.5,5.2,1.3,8.8,4.4,4.4
03154023,Twieflingen,03,Niedersachsen,702,353,349,53,42,11,26,19,7,7.5,6.0,1.6,3.7,2.7,1.0
03154005,Frellstedt,03,Niedersachsen,833,433,400,61,41,20,25,20,5,7.3,4.9,2.4,3.0,2.4,0.6
03154017,Räbke,03,Niedersachsen,683,339,344,49,39,10,20,13,7,7.2,5.7,1.5,2.9,1.9,1.0
03154021,Süpplingen,03,Niedersachsen,1672,824,848,108,71,37,90,61,29,6.5,4.2,2.2,5.4,3.6,1.7
03154022,Süpplingenburg,03,Niedersachsen,654,327,327,40,32,8,13,10,3,6.1,4.9,1.2,2.0,1.5,0.5
03154025,Warberg,03,Niedersachsen,865,443,422,47,36,11,41,32,9,5.4,4.2,1.3,4.7,3.7,1.0
03154026,Wolsdorf,03,Niedersachsen,927,472,455,63,48,15,21,15,6,6.8,5.2,1.6,2.3,1.6,0.6
03154001,Bahrdorf,03,Niedersachsen,1911,986,925,114,82,32,50,39,11,6.0,4.3,1.7,2.6,2.0,0.6
03154004,Danndorf,03,Niedersachsen,2325,1177,1148,135,98,37,39,27,12,5.8,4.2,1.6,1.7,1.2,0.5
03154007,Grafhorst,03,Niedersachsen,1019,501,518,57,35,22,28,23,5,5.6,3.4,2.2,2.7,2.3,0.5
03154009,Groß Twülpstedt,03,Niedersachsen,2630,1348,1282,163,115,48,68,44,24,6.2,4.4,1.8,2.6,1.7,0.9
03154024,Velpke,03,Niedersachsen,4710,2348,2362,353,267,86,239,184,55,7.5,5.7,1.8,5.1,3.9,1.2
03155001,"Bad Gandersheim, Stadt",03,Niedersachsen,10141,4981,5160,759,533,226,753,513,240,7.5,5.3,2.2,7.4,5.1,2.4
03155002,"Bodenfelde, Flecken",03,Niedersachsen,3176,1579,1597,298,213,85,263,200,63,9.4,6.7,2.7,8.3,6.3,2.0
03155003,"Dassel, Stadt",03,Niedersachsen,10223,5089,5134,817,586,231,548,408,140,8.0,5.7,2.3,5.4,4.0,1.4
03155005,"Hardegsen, Stadt",03,Niedersachsen,7815,3815,4000,702,449,253,547,347,200,9.0,5.7,3.2,7.0,4.4,2.6
03155006,Kalefeld,03,Niedersachsen,6543,3275,3268,552,382,170,323,237,86,8.4,5.8,2.6,4.9,3.6,1.3
03155007,Katlenburg-Lindau,03,Niedersachsen,7166,3582,3584,584,389,195,393,269,124,8.1,5.4,2.7,5.5,3.8,1.7
03155009,"Moringen, Stadt",03,Niedersachsen,7071,3656,3415,615,438,177,455,336,119,8.7,6.2,2.5,6.4,4.8,1.7
03155010,"Nörten-Hardenberg, Flecken",03,Niedersachsen,8109,4029,4080,768,467,301,778,532,246,9.5,5.8,3.7,9.6,6.6,3.0
03155011,"Northeim, Stadt",03,Niedersachsen,28920,14077,14843,2698,1877,821,2809,1937,872,9.3,6.5,2.8,9.7,6.7,3.0
03155012,"Uslar, Stadt",03,Niedersachsen,14394,7054,7340,1291,945,346,1187,842,345,9.0,6.6,2.4,8.2,5.8,2.4
03155013,"Einbeck, Stadt",03,Niedersachsen,31338,15257,16081,2627,1832,795,2690,1905,785,8.4,5.8,2.5,8.6,6.1,2.5
03156002,"Bad Lauterberg im Harz, Stadt",03,Niedersachsen,10596,5072,5524,994,737,257,951,708,243,9.4,7.0,2.4,9.0,6.7,2.3
03156003,"Bad Sachsa, Stadt",03,Niedersachsen,7510,3616,3894,618,480,138,483,378,105,8.2,6.4,1.8,6.4,5.0,1.4
03156009,"Herzberg am Harz, Stadt",03,Niedersachsen,13059,6354,6705,1127,841,286,1034,764,270,8.6,6.4,2.2,7.9,5.9,2.1
03156011,"Osterode am Harz, Stadt",03,Niedersachsen,22201,11023,11178,1981,1402,579,1965,1365,600,8.9,6.3,2.6,8.9,6.1,2.7
03156017,Bad Grund (Harz),03,Niedersachsen,8638,4319,4319,734,517,217,538,382,156,8.5,6.0,2.5,6.2,4.4,1.8
03156006,Elbingerode,03,Niedersachsen,437,215,222,33,21,12,-1,-1,-1,7.6,4.8,2.7,-0.2,,
03156008,Hattorf am Harz,03,Niedersachsen,4074,1959,2115,310,223,87,247,170,77,7.6,5.5,2.1,6.1,4.2,1.9
03156010,Hörden am Harz,03,Niedersachsen,991,491,500,83,61,22,-1,-1,-1,8.4,6.2,2.2,-0.1,,
03156015,Wulften am Harz,03,Niedersachsen,1842,914,928,141,98,43,106,78,28,7.7,5.3,2.3,5.8,4.2,1.5
03156012,Walkenried,03,Niedersachsen,2258,1079,1179,179,138,41,125,97,28,7.9,6.1,1.8,5.5,4.3,1.2
03156013,Wieda,03,Niedersachsen,1295,684,611,68,54,14,40,30,10,5.3,4.2,1.1,3.1,2.3,0.8
03156016,Zorge,03,Niedersachsen,984,466,518,75,54,21,80,54,26,7.6,5.5,2.1,8.1,5.5,2.6
03157001,Edemissen,03,Niedersachsen,12349,6040,6309,994,693,301,692,480,212,8.0,5.6,2.4,5.6,3.9,1.7
03157002,Hohenhameln,03,Niedersachsen,9116,4523,4593,783,528,255,611,394,217,8.6,5.8,2.8,6.7,4.3,2.4
03157005,Lengede,03,Niedersachsen,12900,6487,6413,906,645,261,657,492,165,7.0,5.0,2.0,5.1,3.8,1.3
03157006,"Peine, Stadt",03,Niedersachsen,49366,24384,24982,4233,2900,1333,4879,3311,1568,8.6,5.9,2.7,9.9,6.7,3.2
03157007,Vechelde,03,Niedersachsen,16738,8269,8469,1300,865,435,785,554,231,7.8,5.2,2.6,4.7,3.3,1.4
03157008,Wendeburg,03,Niedersachsen,10234,5039,5195,777,519,258,638,455,183,7.6,5.1,2.5,6.2,4.4,1.8
03157009,Ilsede,03,Niedersachsen,21617,10751,10866,1849,1306,543,1250,865,385,8.6,6.0,2.5,5.8,4.0,1.8
03158006,Cremlingen,03,Niedersachsen,13056,6507,6549,891,639,252,632,452,180,6.8,4.9,1.9,4.8,3.5,1.4
03158037,"Wolfenbüttel, Stadt",03,Niedersachsen,52269,25764,26505,4344,3040,1304,4366,3038,1328,8.3,5.8,2.5,8.4,5.8,2.5
03158039,Schladen-Werla,03,Niedersachsen,8789,4287,4502,642,467,175,546,389,157,7.3,5.3,2.0,6.2,4.4,1.8
03158002,Baddeckenstedt,03,Niedersachsen,3069,1507,1562,237,167,70,223,154,69,7.7,5.4,2.3,7.3,5.0,2.2
03158004,Burgdorf,03,Niedersachsen,2294,1131,1163,178,136,42,132,94,38,7.8,5.9,1.8,5.8,4.1,1.7
03158011,Elbe,03,Niedersachsen,1558,763,795,119,80,39,67,41,26,7.6,5.1,2.5,4.3,2.6,1.7
03158016,Haverlah,03,Niedersachsen,1605,812,793,117,88,29,52,38,14,7.3,5.5,1.8,3.2,2.4,0.9
03158018,Heere,03,Niedersachsen,1127,563,564,74,51,23,40,30,10,6.6,4.5,2.0,3.5,2.7,0.9
03158028,Sehlde,03,Niedersachsen,921,455,466,60,39,21,-1,-1,-1,6.5,4.2,2.3,-0.1,,
03158005,Cramme,03,Niedersachsen,906,459,447,75,52,23,-1,-1,-1,8.3,5.7,2.5,-0.1,,
03158010,Dorstadt,03,Niedersachsen,693,359,334,49,37,12,-1,-1,-1,7.1,5.3,1.7,-0.1,,
03158014,Flöthe,03,Niedersachsen,1120,566,554,64,45,19,33,20,13,5.7,4.0,1.7,2.9,1.8,1.2
03158019,Heiningen,03,Niedersachsen,657,336,321,59,44,15,19,16,3,9.0,6.7,2.3,2.9,2.4,0.5
03158023,Ohrum,03,Niedersachsen,634,314,320,48,35,13,17,11,6,7.6,5.5,2.1,2.7,1.7,0.9
03158038,Börßum,03,Niedersachsen,2856,1406,1450,179,121,58,102,77,25,6.3,4.2,2.0,3.6,2.7,0.9
03158009,Dettum,03,Niedersachsen,1231,618,613,112,71,41,26,15,11,9.1,5.8,3.3,2.1,1.2,0.9
03158012,Erkerode,03,Niedersachsen,931,470,461,61,37,24,51,32,19,6.6,4.0,2.6,5.5,3.4,2.0
03158013,Evessen,03,Niedersachsen,1292,652,640,97,68,29,77,60,17,7.5,5.3,2.2,6.0,4.6,1.3
03158030,Sickte,03,Niedersachsen,6172,3067,3105,344,229,115,322,233,89,5.6,3.7,1.9,5.2,3.8,1.4
03158033,Veltheim (Ohe),03,Niedersachsen,992,486,506,74,48,26,44,35,9,7.5,4.8,2.6,4.4,3.5,0.9
03158007,Dahlum,03,Niedersachsen,656,323,333,65,47,18,16,-1,-1,9.9,7.2,2.7,2.4,,
03158008,Denkte,03,Niedersachsen,2981,1443,1538,231,163,68,117,82,35,7.7,5.5,2.3,3.9,2.8,1.2
03158017,Hedeper,03,Niedersachsen,504,258,246,51,43,8,38,32,6,10.1,8.5,1.6,7.5,6.3,1.2
03158021,Kissenbrück,03,Niedersachsen,1779,879,900,131,94,37,68,54,14,7.4,5.3,2.1,3.8,3.0,0.8
03158022,Kneitlingen,03,Niedersachsen,828,415,413,49,36,13,44,32,12,5.9,4.3,1.6,5.3,3.9,1.4
03158024,Remlingen,03,Niedersachsen,1824,911,913,109,67,42,58,47,11,6.0,3.7,2.3,3.2,2.6,0.6
03158025,Roklum,03,Niedersachsen,444,221,223,36,26,10,4,-1,-1,8.1,5.9,2.3,0.9,,
03158027,"Schöppenstedt, Stadt",03,Niedersachsen,5606,2741,2865,392,294,98,303,233,70,7.0,5.2,1.7,5.4,4.2,1.2
03158029,Semmenstedt,03,Niedersachsen,635,320,315,51,36,15,25,18,7,8.0,5.7,2.4,3.9,2.8,1.1
03158031,Uehrde,03,Niedersachsen,908,445,463,64,47,17,27,22,5,7.0,5.2,1.9,3.0,2.4,0.6
03158032,Vahlberg,03,Niedersachsen,752,390,362,48,31,17,27,21,6,6.4,4.1,2.3,3.6,2.8,0.8
03158035,Winnigstedt,03,Niedersachsen,733,393,340,71,52,19,36,28,8,9.7,7.1,2.6,4.9,3.8,1.1
03158036,Wittmar,03,Niedersachsen,1159,585,574,81,59,22,47,34,13,7.0,5.1,1.9,4.1,2.9,1.1
03241001,"Hannover, Landeshauptstadt",03,Niedersachsen,532163,259749,272414,47172,31535,15637,56551,37628,18923,8.9,5.9,2.9,10.6,7.1,3.6
03241002,"Barsinghausen, Stadt",03,Niedersachsen,33608,16550,17058,2692,1795,897,2009,1356,653,8.0,5.3,2.7,6.0,4.0,1.9
03241003,"Burgdorf, Stadt",03,Niedersachsen,30147,14714,15433,2634,1788,846,2369,1564,805,8.7,5.9,2.8,7.9,5.2,2.7
03241004,"Burgwedel, Stadt",03,Niedersachsen,20654,9852,10802,1773,1174,599,1685,1164,521,8.6,5.7,2.9,8.2,5.6,2.5
03241005,"Garbsen, Stadt",03,Niedersachsen,60590,29582,31008,5554,3692,1862,5296,3536,1760,9.2,6.1,3.1,8.7,5.8,2.9
03241006,"Gehrden, Stadt",03,Niedersachsen,14624,6990,7634,1185,797,388,902,647,255,8.1,5.4,2.7,6.2,4.4,1.7
03241007,"Hemmingen, Stadt",03,Niedersachsen,18793,9160,9633,1492,981,511,1536,1054,482,7.9,5.2,2.7,8.2,5.6,2.6
03241008,Isernhagen,03,Niedersachsen,23792,11654,12138,1900,1249,651,2311,1518,793,8.0,5.2,2.7,9.7,6.4,3.3
03241009,"Laatzen, Stadt",03,Niedersachsen,40939,19726,21213,3476,2247,1229,5091,3170,1921,8.5,5.5,3.0,12.4,7.7,4.7
03241010,"Langenhagen, Stadt",03,Niedersachsen,53323,26190,27133,5045,3158,1887,5655,3581,2074,9.5,5.9,3.5,10.6,6.7,3.9
03241011,"Lehrte, Stadt",03,Niedersachsen,43639,21704,21935,3683,2391,1292,2955,1991,964,8.4,5.5,3.0,6.8,4.6,2.2
03241012,"Neustadt am Rübenberge, Stadt",03,Niedersachsen,43931,21734,22197,3635,2501,1134,3531,2430,1101,8.3,5.7,2.6,8.0,5.5,2.5
03241013,"Pattensen, Stadt",03,Niedersachsen,14324,6958,7366,1145,741,404,1080,723,357,8.0,5.2,2.8,7.5,5.0,2.5
03241014,"Ronnenberg, Stadt",03,Niedersachsen,23752,11749,12003,2055,1343,712,1473,959,514,8.7,5.7,3.0,6.2,4.0,2.2
03241015,"Seelze, Stadt",03,Niedersachsen,33283,16446,16837,2854,1857,997,1627,1100,527,8.6,5.6,3.0,4.9,3.3,1.6
03241016,"Sehnde, Stadt",03,Niedersachsen,23489,11861,11628,1868,1209,659,1528,975,553,8.0,5.1,2.8,6.5,4.2,2.4
03241017,"Springe, Stadt",03,Niedersachsen,28682,13910,14772,2298,1552,746,1944,1325,619,8.0,5.4,2.6,6.8,4.6,2.2
03241018,Uetze,03,Niedersachsen,20103,9933,10170,1765,1234,531,1198,865,333,8.8,6.1,2.6,6.0,4.3,1.7
03241019,Wedemark,03,Niedersachsen,29358,14380,14978,2596,1673,923,3036,2087,949,8.8,5.7,3.1,10.3,7.1,3.2
03241020,Wennigsen (Deister),03,Niedersachsen,14036,6871,7165,1064,722,342,1166,810,356,7.6,5.1,2.4,8.3,5.8,2.5
03241021,"Wunstorf, Stadt",03,Niedersachsen,41251,20062,21189,3540,2446,1094,3318,2278,1040,8.6,5.9,2.7,8.0,5.5,2.5
03251007,"Bassum, Stadt",03,Niedersachsen,15768,7816,7952,1694,1121,573,1547,1031,516,10.7,7.1,3.6,9.8,6.5,3.3
03251012,"Diepholz, Stadt",03,Niedersachsen,16692,8263,8429,1842,1158,684,1602,1011,591,11.0,6.9,4.1,9.6,6.1,3.5
03251037,Stuhr,03,Niedersachsen,33083,16093,16990,3244,2041,1203,3857,2474,1383,9.8,6.2,3.6,11.7,7.5,4.2
03251040,"Sulingen, Stadt",03,Niedersachsen,12681,6288,6393,1328,877,451,1477,997,480,10.5,6.9,3.6,11.6,7.9,3.8
03251041,"Syke, Stadt",03,Niedersachsen,24018,11871,12147,2602,1731,871,4240,2834,1406,10.8,7.2,3.6,17.7,11.8,5.9
03251042,"Twistringen, Stadt",03,Niedersachsen,12219,6168,6051,1562,1064,498,1301,882,419,12.8,8.7,4.1,10.6,7.2,3.4
03251044,Wagenfeld,03,Niedersachsen,7102,3585,3517,897,523,374,721,432,289,12.6,7.4,5.3,10.2,6.1,4.1
03251047,Weyhe,03,Niedersachsen,30388,14897,15491,3075,1936,1139,2520,1621,899,10.1,6.4,3.7,8.3,5.3,3.0
03251009,Brockum,03,Niedersachsen,1021,499,522,123,76,47,64,31,33,12.0,7.4,4.6,6.3,3.0,3.2
03251020,Hüde,03,Niedersachsen,1131,591,540,122,79,43,151,92,59,10.8,7.0,3.8,13.4,8.1,5.2
03251022,Lembruch,03,Niedersachsen,1148,589,559,137,82,55,281,187,94,11.9,7.1,4.8,24.5,16.3,8.2
03251023,"Lemförde, Flecken",03,Niedersachsen,3105,1491,1614,379,235,144,337,236,101,12.2,7.6,4.6,10.9,7.6,3.3
03251025,Marl,03,Niedersachsen,718,375,343,70,40,30,160,102,58,9.7,5.6,4.2,22.3,14.2,8.1
03251029,Quernheim,03,Niedersachsen,424,219,205,50,30,20,-1,-1,-1,11.8,7.1,4.7,-0.2,,
03251036,Stemshorn,03,Niedersachsen,664,322,342,84,57,27,59,43,16,12.7,8.6,4.1,8.9,6.5,2.4
03251005,"Barnstorf, Flecken",03,Niedersachsen,6292,3166,3126,702,448,254,845,515,330,11.2,7.1,4.0,13.4,8.2,5.2
03251013,Drebber,03,Niedersachsen,2971,1505,1466,340,199,141,191,114,77,11.4,6.7,4.7,6.4,3.8,2.6
03251014,Drentwede,03,Niedersachsen,994,507,487,117,76,41,85,49,36,11.8,7.6,4.1,8.6,4.9,3.6
03251017,Eydelstedt,03,Niedersachsen,1759,887,872,188,117,71,190,97,93,10.7,6.7,4.0,10.8,5.5,5.3
03251002,Asendorf,03,Niedersachsen,2919,1459,1460,328,208,120,305,183,122,11.2,7.1,4.1,10.4,6.3,4.2
03251026,Martfeld,03,Niedersachsen,2681,1347,1334,283,183,100,219,149,70,10.6,6.8,3.7,8.2,5.6,2.6
03251033,Schwarme,03,Niedersachsen,2534,1315,1219,269,188,81,210,118,92,10.6,7.4,3.2,8.3,4.7,3.6
03251039,Süstedt,03,Niedersachsen,1559,800,759,149,90,59,140,75,65,9.6,5.8,3.8,9.0,4.8,4.2
03251048,"Bruchhausen-Vilsen, Flecken",03,Niedersachsen,7278,3533,3745,836,514,322,834,515,319,11.5,7.1,4.4,11.5,7.1,4.4
03251003,Bahrenborstel,03,Niedersachsen,1134,582,552,150,98,52,117,80,37,13.2,8.6,4.6,10.3,7.1,3.3
03251004,"Barenburg, Flecken",03,Niedersachsen,1242,641,601,157,106,51,78,50,28,12.6,8.5,4.1,6.3,4.0,2.3
03251018,Freistatt,03,Niedersachsen,632,508,124,21,11,10,-1,-1,-1,3.3,1.7,1.6,-0.2,,
03251021,Kirchdorf,03,Niedersachsen,2145,1111,1034,236,149,87,299,194,105,11.0,6.9,4.1,13.9,9.0,4.9
03251043,Varrel,03,Niedersachsen,1504,795,709,160,102,58,99,65,34,10.6,6.8,3.9,6.6,4.3,2.3
03251045,Wehrbleck,03,Niedersachsen,787,422,365,79,55,24,57,43,14,10.0,7.0,3.0,7.2,5.5,1.8
03251006,Barver,03,Niedersachsen,1049,549,500,111,65,46,84,34,50,10.6,6.2,4.4,8.0,3.2,4.8
03251011,Dickel,03,Niedersachsen,462,227,235,57,32,25,32,14,18,12.3,6.9,5.4,6.9,3.0,3.9
03251019,Hemsloh,03,Niedersachsen,563,285,278,52,34,18,72,36,36,9.2,6.0,3.2,12.8,6.4,6.4
03251030,Rehden,03,Niedersachsen,2055,1037,1018,237,126,111,266,147,119,11.5,6.1,5.4,12.9,7.2,5.8
03251046,Wetschen,03,Niedersachsen,1758,907,851,223,132,91,163,93,70,12.7,7.5,5.2,9.3,5.3,4.0
03251001,Affinghausen,03,Niedersachsen,832,396,436,93,66,27,45,32,13,11.2,7.9,3.2,5.4,3.8,1.6
03251015,Ehrenburg,03,Niedersachsen,1510,780,730,171,110,61,116,56,60,11.3,7.3,4.0,7.7,3.7,4.0
03251028,Neuenkirchen,03,Niedersachsen,1163,582,581,140,88,52,66,43,23,12.0,7.6,4.5,5.7,3.7,2.0
03251031,Scholen,03,Niedersachsen,808,424,384,87,64,23,56,37,19,10.8,7.9,2.8,6.9,4.6,2.4
03251032,Schwaförden,03,Niedersachsen,1523,807,716,171,107,64,76,48,28,11.2,7.0,4.2,5.0,3.2,1.8
03251038,Sudwalde,03,Niedersachsen,1056,525,531,139,92,47,85,60,25,13.2,8.7,4.5,8.0,5.7,2.4
03251008,Borstel,03,Niedersachsen,1249,619,630,123,82,41,90,74,16,9.8,6.6,3.3,7.2,5.9,1.3
03251024,Maasen,03,Niedersachsen,469,241,228,43,30,13,17,10,7,9.2,6.4,2.8,3.6,2.1,1.5
03251027,Mellinghausen,03,Niedersachsen,1075,534,541,107,77,30,43,33,10,10.0,7.2,2.8,4.0,3.1,0.9
03251034,"Siedenburg, Flecken",03,Niedersachsen,1278,646,632,127,85,42,101,73,28,9.9,6.7,3.3,7.9,5.7,2.2
03251035,Staffhorst,03,Niedersachsen,533,271,262,64,41,23,64,32,32,12.0,7.7,4.3,12.0,6.0,6.0
03252001,"Aerzen, Flecken",03,Niedersachsen,10693,5246,5447,916,620,296,605,390,215,8.6,5.8,2.8,5.7,3.6,2.0
03252002,"Bad Münder am Deister, Stadt",03,Niedersachsen,17376,8513,8863,1397,982,415,1062,729,333,8.0,5.7,2.4,6.1,4.2,1.9
03252003,"Bad Pyrmont, Stadt",03,Niedersachsen,19239,9096,10143,1764,1220,544,1775,1222,553,9.2,6.3,2.8,9.2,6.4,2.9
03252004,"Coppenbrügge, Flecken",03,Niedersachsen,7152,3498,3654,628,439,189,441,308,133,8.8,6.1,2.6,6.2,4.3,1.9
03252005,Emmerthal,03,Niedersachsen,9876,4814,5062,868,572,296,639,451,188,8.8,5.8,3.0,6.5,4.6,1.9
03252006,"Hameln, Stadt",03,Niedersachsen,56529,26897,29632,4893,3333,1560,6087,4175,1912,8.7,5.9,2.8,10.8,7.4,3.4
03252007,"Hessisch Oldendorf, Stadt",03,Niedersachsen,18119,8941,9178,1562,1030,532,1217,832,385,8.6,5.7,2.9,6.7,4.6,2.1
03252008,"Salzhemmendorf, Flecken",03,Niedersachsen,9297,4601,4696,792,542,250,556,379,177,8.5,5.8,2.7,6.0,4.1,1.9
03254002,"Alfeld (Leine), Stadt",03,Niedersachsen,19081,9410,9671,1634,1200,434,1948,1440,508,8.6,6.3,2.3,10.2,7.5,2.7
03254003,Algermissen,03,Niedersachsen,7738,3851,3887,590,376,214,343,231,112,7.6,4.9,2.8,4.4,3.0,1.4
03254005,"Bad Salzdetfurth, Stadt",03,Niedersachsen,13269,6520,6749,1161,801,360,872,608,264,8.7,6.0,2.7,6.6,4.6,2.0
03254008,"Bockenem, Stadt",03,Niedersachsen,9659,4823,4836,835,571,264,595,417,178,8.6,5.9,2.7,6.2,4.3,1.8
03254011,Diekholzen,03,Niedersachsen,6493,3163,3330,492,332,160,284,182,102,7.6,5.1,2.5,4.4,2.8,1.6
03254014,"Elze, Stadt",03,Niedersachsen,8767,4281,4486,745,525,220,571,418,153,8.5,6.0,2.5,6.5,4.8,1.7
03254017,Giesen,03,Niedersachsen,9707,4806,4901,823,551,272,642,436,206,8.5,5.7,2.8,6.6,4.5,2.1
03254020,Harsum,03,Niedersachsen,11445,5669,5776,1034,678,356,701,475,226,9.0,5.9,3.1,6.1,4.2,2.0
03254021,"Hildesheim, Stadt",03,Niedersachsen,101667,48291,53376,9527,6812,2715,10574,7448,3126,9.4,6.7,2.7,10.4,7.3,3.1
03254022,Holle,03,Niedersachsen,7124,3509,3615,563,372,191,419,315,104,7.9,5.2,2.7,5.9,4.4,1.5
03254026,Nordstemmen,03,Niedersachsen,12143,5965,6178,918,601,317,606,402,204,7.6,4.9,2.6,5.0,3.3,1.7
03254028,"Sarstedt, Stadt",03,Niedersachsen,19303,9582,9721,1771,1209,562,1605,1109,496,9.2,6.3,2.9,8.3,5.7,2.6
03254029,Schellerten,03,Niedersachsen,8024,3983,4041,677,463,214,499,361,138,8.4,5.8,2.7,6.2,4.5,1.7
03254032,Söhlde,03,Niedersachsen,7796,3844,3952,695,493,202,715,551,164,8.9,6.3,2.6,9.2,7.1,2.1
03254015,Everode,03,Niedersachsen,463,232,231,45,34,11,4,-1,-1,9.7,7.3,2.4,0.9,,
03254016,Freden (Leine),03,Niedersachsen,3034,1511,1523,261,198,63,149,113,36,8.6,6.5,2.1,4.9,3.7,1.2
03254024,Landwehr,03,Niedersachsen,542,286,256,47,35,12,12,9,3,8.7,6.5,2.2,2.2,1.7,0.6
03254034,Winzenburg,03,Niedersachsen,688,344,344,34,28,6,56,36,20,4.9,4.1,0.9,8.1,5.2,2.9
03254006,Banteln,03,Niedersachsen,1507,748,759,124,87,37,58,47,11,8.2,5.8,2.5,3.8,3.1,0.7
03254007,Betheln,03,Niedersachsen,972,492,480,77,50,27,40,25,15,7.9,5.1,2.8,4.1,2.6,1.5
03254009,Brüggen,03,Niedersachsen,865,440,425,73,49,24,24,18,6,8.4,5.7,2.8,2.8,2.1,0.7
03254010,Despetal,03,Niedersachsen,1237,596,641,112,78,34,22,14,8,9.1,6.3,2.7,1.8,1.1,0.6
03254013,"Eime, Flecken",03,Niedersachsen,2625,1344,1281,210,144,66,226,171,55,8.0,5.5,2.5,8.6,6.5,2.1
03254018,"Gronau (Leine), Stadt",03,Niedersachsen,5358,2583,2775,459,305,154,830,591,239,8.6,5.7,2.9,15.5,11.0,4.5
03254027,Rheden,03,Niedersachsen,1015,510,505,105,70,35,92,63,29,10.3,6.9,3.4,9.1,6.2,2.9
03254019,Harbarnsen,03,Niedersachsen,555,271,284,58,44,14,29,19,10,10.5,7.9,2.5,5.2,3.4,1.8
03254023,"Lamspringe, Flecken",03,Niedersachsen,2975,1456,1519,259,185,74,496,398,98,8.7,6.2,2.5,16.7,13.4,3.3
03254025,Neuhof,03,Niedersachsen,437,207,230,41,34,7,12,9,3,9.4,7.8,1.6,2.7,2.1,0.7
03254030,Sehlem,03,Niedersachsen,842,423,419,69,45,24,26,17,9,8.2,5.3,2.9,3.1,2.0,1.1
03254035,Woltershausen,03,Niedersachsen,817,404,413,73,52,21,17,12,5,8.9,6.4,2.6,2.1,1.5,0.6
03254001,Adenstedt,03,Niedersachsen,962,494,468,101,62,39,42,28,14,10.5,6.4,4.1,4.4,2.9,1.5
03254004,Almstedt,03,Niedersachsen,886,448,438,72,50,22,43,28,15,8.1,5.6,2.5,4.9,3.2,1.7
03254012,Eberholzen,03,Niedersachsen,564,278,286,50,32,18,-1,-1,-1,8.9,5.7,3.2,-0.2,,
03254031,Sibbesse,03,Niedersachsen,2593,1287,1306,224,164,60,91,61,30,8.6,6.3,2.3,3.5,2.4,1.2
03254033,Westfeld,03,Niedersachsen,895,447,448,69,44,25,14,10,4,7.7,4.9,2.8,1.6,1.1,0.4
03254036,Coppengrave,03,Niedersachsen,616,308,308,53,36,17,-1,-1,-1,8.6,5.8,2.8,-0.2,,
03254037,"Duingen, Flecken",03,Niedersachsen,2863,1432,1431,252,173,79,337,203,134,8.8,6.0,2.8,11.8,7.1,4.7
03254038,Hoyershausen,03,Niedersachsen,439,224,215,54,36,18,47,26,21,12.3,8.2,4.1,10.7,5.9,4.8
03254039,Marienhagen,03,Niedersachsen,727,361,366,49,34,15,-1,-1,-1,6.7,4.7,2.1,-0.1,,
03254040,Weenzen,03,Niedersachsen,362,184,178,41,28,13,10,4,6,11.3,7.7,3.6,2.8,1.1,1.7
03255008,"Delligsen, Flecken",03,Niedersachsen,8048,4014,4034,675,498,177,487,350,137,8.4,6.2,2.2,6.1,4.3,1.7
03255023,"Holzminden, Stadt",03,Niedersachsen,20099,9910,10189,1744,1305,439,2239,1685,554,8.7,6.5,2.2,11.1,8.4,2.8
03255002,"Bevern, Flecken",03,Niedersachsen,3864,1866,1998,336,235,101,351,235,116,8.7,6.1,2.6,9.1,6.1,3.0
03255015,Golmbach,03,Niedersachsen,934,471,463,92,65,27,45,32,13,9.9,7.0,2.9,4.8,3.4,1.4
03255021,Holenberg,03,Niedersachsen,401,196,205,32,24,8,13,-1,-1,8.0,6.0,2.0,3.2,,
03255030,Negenborn,03,Niedersachsen,680,344,336,60,42,18,22,16,6,8.8,6.2,2.6,3.2,2.4,0.9
03255004,Boffzen,03,Niedersachsen,2756,1350,1406,226,171,55,192,142,50,8.2,6.2,2.0,7.0,5.2,1.8
03255009,Derental,03,Niedersachsen,583,283,300,61,46,15,37,26,11,10.5,7.9,2.6,6.3,4.5,1.9
03255014,Fürstenberg,03,Niedersachsen,1099,530,569,99,68,31,81,50,31,9.0,6.2,2.8,7.4,4.5,2.8
03255026,"Lauenförde, Flecken",03,Niedersachsen,2451,1218,1233,227,177,50,237,167,70,9.3,7.2,2.0,9.7,6.8,2.9
03255003,"Bodenwerder, Münchhausenstadt",03,Niedersachsen,5597,2724,2873,489,344,145,528,382,146,8.7,6.1,2.6,9.4,6.8,2.6
03255005,Brevörde,03,Niedersachsen,631,317,314,46,33,13,-1,-1,-1,7.3,5.2,2.1,-0.2,,
03255016,Halle,03,Niedersachsen,1519,757,762,148,113,35,83,53,30,9.7,7.4,2.3,5.5,3.5,2.0
03255017,Hehlen,03,Niedersachsen,1834,938,896,144,103,41,140,97,43,7.9,5.6,2.2,7.6,5.3,2.3
03255019,Heinsen,03,Niedersachsen,794,397,397,60,44,16,15,-1,-1,7.6,5.5,2.0,1.9,,
03255020,Heyen,03,Niedersachsen,443,227,216,41,22,19,21,11,10,9.3,5.0,4.3,4.7,2.5,2.3
03255025,Kirchbrak,03,Niedersachsen,999,506,493,83,65,18,65,46,19,8.3,6.5,1.8,6.5,4.6,1.9
03255031,"Ottenstein, Flecken",03,Niedersachsen,1143,573,570,94,70,24,66,49,17,8.2,6.1,2.1,5.8,4.3,1.5
03255032,Pegestorf,03,Niedersachsen,381,185,196,43,36,7,-1,-1,-1,11.3,9.4,1.8,-0.3,,
03255033,"Polle, Flecken",03,Niedersachsen,1193,608,585,93,68,25,105,73,32,7.8,5.7,2.1,8.8,6.1,2.7
03255035,Vahlbruch,03,Niedersachsen,419,216,203,26,19,7,-1,-1,-1,6.2,4.5,1.7,-0.2,,
03255001,Arholzen,03,Niedersachsen,415,208,207,31,19,12,-1,-1,-1,7.5,4.6,2.9,-0.2,,
03255007,Deensen,03,Niedersachsen,1388,704,684,96,63,33,51,34,17,6.9,4.5,2.4,3.7,2.4,1.2
03255010,Dielmissen,03,Niedersachsen,775,375,400,66,46,20,28,15,13,8.5,5.9,2.6,3.6,1.9,1.7
03255012,Eimen,03,Niedersachsen,889,446,443,73,57,16,18,13,5,8.2,6.4,1.8,2.0,1.5,0.6
03255013,"Eschershausen, Stadt",03,Niedersachsen,3649,1896,1753,264,202,62,249,185,64,7.2,5.5,1.7,6.8,5.1,1.8
03255018,Heinade,03,Niedersachsen,896,439,457,62,43,19,16,13,3,6.9,4.8,2.1,1.8,1.5,0.3
03255022,Holzen,03,Niedersachsen,558,258,300,50,42,8,14,10,4,9.0,7.5,1.4,2.5,1.8,0.7
03255027,Lenne,03,Niedersachsen,648,324,324,60,45,15,-1,-1,-1,9.3,6.9,2.3,-0.2,,
03255028,Lüerdissen,03,Niedersachsen,405,208,197,27,20,7,13,8,5,6.7,4.9,1.7,3.2,2.0,1.2
03255034,"Stadtoldendorf, Stadt",03,Niedersachsen,5603,2713,2890,431,326,105,389,289,100,7.7,5.8,1.9,6.9,5.2,1.8
03255036,Wangelnstedt,03,Niedersachsen,565,280,285,56,42,14,25,16,9,9.9,7.4,2.5,4.4,2.8,1.6
03256022,"Nienburg (Weser), Stadt",03,Niedersachsen,31193,15159,16034,2817,2030,787,3482,2427,1055,9.0,6.5,2.5,11.2,7.8,3.4
03256025,"Rehburg-Loccum, Stadt",03,Niedersachsen,10154,5129,5025,834,557,277,707,492,215,8.2,5.5,2.7,7.0,4.8,2.1
03256030,"Steyerberg, Flecken",03,Niedersachsen,5262,2608,2654,497,337,160,391,257,134,9.4,6.4,3.0,7.4,4.9,2.5
03256005,"Drakenburg, Flecken",03,Niedersachsen,1734,885,849,170,117,53,117,73,44,9.8,6.7,3.1,6.7,4.2,2.5
03256011,Haßbergen,03,Niedersachsen,1559,766,793,143,91,52,58,37,21,9.2,5.8,3.3,3.7,2.4,1.3
03256012,Heemsen,03,Niedersachsen,1706,854,852,197,123,74,77,43,34,11.5,7.2,4.3,4.5,2.5,2.0
03256027,Rohrsen,03,Niedersachsen,1020,506,514,111,82,29,69,49,20,10.9,8.0,2.8,6.8,4.8,2.0
03256002,Binnen,03,Niedersachsen,1010,520,490,91,57,34,40,27,13,9.0,5.6,3.4,4.0,2.7,1.3
03256019,"Liebenau, Flecken",03,Niedersachsen,3688,1895,1793,310,216,94,223,154,69,8.4,5.9,2.5,6.0,4.2,1.9
03256023,Pennigsehl,03,Niedersachsen,1252,648,604,145,99,46,254,211,43,11.6,7.9,3.7,20.3,16.9,3.4
03256001,Balge,03,Niedersachsen,1752,884,868,155,112,43,71,46,25,8.8,6.4,2.5,4.1,2.6,1.4
03256021,Marklohe,03,Niedersachsen,4432,2169,2263,352,238,114,293,208,85,7.9,5.4,2.6,6.6,4.7,1.9
03256036,Wietzen,03,Niedersachsen,2165,1062,1103,217,146,71,172,134,38,10.0,6.7,3.3,7.9,6.2,1.8
03256020,Linsburg,03,Niedersachsen,922,463,459,71,47,24,33,-1,-1,7.7,5.1,2.6,3.6,,
03256026,Rodewald,03,Niedersachsen,2496,1263,1233,215,146,69,146,111,35,8.6,5.8,2.8,5.8,4.4,1.4
03256029,Steimbke,03,Niedersachsen,2466,1224,1242,235,148,87,223,137,86,9.5,6.0,3.5,9.0,5.6,3.5
03256031,Stöckse,03,Niedersachsen,1302,667,635,103,71,32,32,21,11,7.9,5.5,2.5,2.5,1.6,0.8
03256004,"Diepenau, Flecken",03,Niedersachsen,3883,1988,1895,400,264,136,339,234,105,10.3,6.8,3.5,8.7,6.0,2.7
03256024,Raddestorf,03,Niedersachsen,1886,958,928,201,138,63,107,67,40,10.7,7.3,3.3,5.7,3.6,2.1
03256033,"Uchte, Flecken",03,Niedersachsen,4882,2470,2412,479,335,144,434,303,131,9.8,6.9,2.9,8.9,6.2,2.7
03256034,Warmsen,03,Niedersachsen,3281,1654,1627,317,210,107,222,163,59,9.7,6.4,3.3,6.8,5.0,1.8
03256003,"Bücken, Flecken",03,Niedersachsen,2139,1079,1060,213,131,82,155,98,57,10.0,6.1,3.8,7.2,4.6,2.7
03256007,Eystrup,03,Niedersachsen,3251,1589,1662,346,216,130,216,156,60,10.6,6.6,4.0,6.6,4.8,1.8
03256008,Gandesbergen,03,Niedersachsen,478,240,238,40,24,16,8,-1,-1,8.4,5.0,3.3,1.7,,
03256009,Hämelhausen,03,Niedersachsen,571,294,277,65,46,19,28,20,8,11.4,8.1,3.3,4.9,3.5,1.4
03256010,Hassel (Weser),03,Niedersachsen,1856,912,944,186,121,65,86,46,40,10.0,6.5,3.5,4.6,2.5,2.2
03256013,Hilgermissen,03,Niedersachsen,2181,1103,1078,245,149,96,128,74,54,11.2,6.8,4.4,5.9,3.4,2.5
03256014,"Hoya, Stadt",03,Niedersachsen,3772,1851,1921,431,288,143,660,456,204,11.4,7.6,3.8,17.5,12.1,5.4
03256015,Hoyerhagen,03,Niedersachsen,953,472,481,94,58,36,40,28,12,9.9,6.1,3.8,4.2,2.9,1.3
03256028,Schweringen,03,Niedersachsen,800,405,395,87,51,36,98,55,43,10.9,6.4,4.5,12.2,6.9,5.4
03256035,Warpe,03,Niedersachsen,756,403,353,55,38,17,91,60,31,7.3,5.0,2.2,12.0,7.9,4.1
03256006,Estorf,03,Niedersachsen,1668,823,845,140,101,39,84,49,35,8.4,6.1,2.3,5.0,2.9,2.1
03256016,Husum,03,Niedersachsen,2338,1189,1149,231,165,66,150,89,61,9.9,7.1,2.8,6.4,3.8,2.6
03256017,Landesbergen,03,Niedersachsen,2730,1329,1401,249,160,89,142,108,34,9.1,5.9,3.3,5.2,4.0,1.2
03256018,Leese,03,Niedersachsen,1638,820,818,142,101,41,165,115,50,8.7,6.2,2.5,10.1,7.0,3.1
03256032,Stolzenau,03,Niedersachsen,7456,3666,3790,702,497,205,568,406,162,9.4,6.7,2.7,7.6,5.4,2.2
03257003,Auetal,03,Niedersachsen,6315,3135,3180,586,414,172,336,246,90,9.3,6.6,2.7,5.3,3.9,1.4
03257009,"Bückeburg, Stadt",03,Niedersachsen,19182,9261,9921,1733,1207,526,1873,1304,569,9.0,6.3,2.7,9.8,6.8,3.0
03257028,"Obernkirchen, Stadt",03,Niedersachsen,9196,4580,4616,802,569,233,662,486,176,8.7,6.2,2.5,7.2,5.3,1.9
03257031,"Rinteln, Stadt",03,Niedersachsen,25187,12300,12887,2284,1624,660,2344,1609,735,9.1,6.4,2.6,9.3,6.4,2.9
03257035,"Stadthagen, Stadt",03,Niedersachsen,21814,10478,11336,1903,1416,487,2080,1538,542,8.7,6.5,2.2,9.5,7.1,2.5
03257001,Ahnsen,03,Niedersachsen,1045,516,529,109,78,31,149,107,42,10.4,7.5,3.0,14.3,10.2,4.0
03257005,Bad Eilsen,03,Niedersachsen,2480,1098,1382,154,92,62,218,145,73,6.2,3.7,2.5,8.8,5.8,2.9
03257008,Buchholz,03,Niedersachsen,724,360,364,60,37,23,20,10,10,8.3,5.1,3.2,2.8,1.4,1.4
03257012,Heeßen,03,Niedersachsen,1385,659,726,108,75,33,45,31,14,7.8,5.4,2.4,3.2,2.2,1.0
03257022,Luhden,03,Niedersachsen,1081,558,523,88,61,27,88,62,26,8.1,5.6,2.5,8.1,5.7,2.4
03257007,Beckedorf,03,Niedersachsen,1442,718,724,149,106,43,53,37,16,10.3,7.4,3.0,3.7,2.6,1.1
03257015,Heuerßen,03,Niedersachsen,938,455,483,78,60,18,41,29,12,8.3,6.4,1.9,4.4,3.1,1.3
03257020,Lindhorst,03,Niedersachsen,4351,2125,2226,384,271,113,319,237,82,8.8,6.2,2.6,7.3,5.4,1.9
03257021,Lüdersfeld,03,Niedersachsen,1065,552,513,104,72,32,119,82,37,9.8,6.8,3.0,11.2,7.7,3.5
03257006,"Bad Nenndorf, Stadt",03,Niedersachsen,10649,4985,5664,832,585,247,981,692,289,7.8,5.5,2.3,9.2,6.5,2.7
03257011,Haste,03,Niedersachsen,2749,1322,1427,194,133,61,114,82,32,7.1,4.8,2.2,4.1,3.0,1.2
03257016,Hohnhorst,03,Niedersachsen,2076,1041,1035,167,116,51,78,57,21,8.0,5.6,2.5,3.8,2.7,1.0
03257036,Suthfeld,03,Niedersachsen,1486,726,760,119,82,37,47,34,13,8.0,5.5,2.5,3.2,2.3,0.9
03257019,Lauenhagen,03,Niedersachsen,1338,643,695,131,96,35,40,35,5,9.8,7.2,2.6,3.0,2.6,0.4
03257023,Meerbeck,03,Niedersachsen,1965,951,1014,170,115,55,103,69,34,8.7,5.9,2.8,5.2,3.5,1.7
03257025,Niedernwöhren,03,Niedersachsen,1978,972,1006,174,129,45,211,156,55,8.8,6.5,2.3,10.7,7.9,2.8
03257027,Nordsehl,03,Niedersachsen,730,357,373,48,37,11,29,19,10,6.6,5.1,1.5,4.0,2.6,1.4
03257030,Pollhagen,03,Niedersachsen,1104,557,547,95,68,27,51,32,19,8.6,6.2,2.4,4.6,2.9,1.7
03257037,"Wiedensahl, Flecken",03,Niedersachsen,1000,504,496,107,71,36,62,44,18,10.7,7.1,3.6,6.2,4.4,1.8
03257013,Helpsen,03,Niedersachsen,1944,953,991,182,130,52,128,90,38,9.4,6.7,2.7,6.6,4.6,2.0
03257014,Hespe,03,Niedersachsen,2058,995,1063,172,124,48,140,104,36,8.4,6.0,2.3,6.8,5.1,1.7
03257026,Nienstädt,03,Niedersachsen,4566,2289,2277,382,268,114,237,166,71,8.4,5.9,2.5,5.2,3.6,1.6
03257034,Seggebruch,03,Niedersachsen,1543,787,756,151,111,40,57,38,19,9.8,7.2,2.6,3.7,2.5,1.2
03257002,Apelern,03,Niedersachsen,2470,1262,1208,196,122,74,65,43,22,7.9,4.9,3.0,2.6,1.7,0.9
03257017,Hülsede,03,Niedersachsen,1049,532,517,98,75,23,65,40,25,9.3,7.1,2.2,6.2,3.8,2.4
03257018,"Lauenau, Flecken",03,Niedersachsen,4100,2024,2076,310,231,79,326,229,97,7.6,5.6,1.9,8.0,5.6,2.4
03257024,Messenkamp,03,Niedersachsen,744,359,385,71,45,26,26,19,7,9.5,6.0,3.5,3.5,2.6,0.9
03257029,Pohle,03,Niedersachsen,851,436,415,82,57,25,44,33,11,9.6,6.7,2.9,5.2,3.9,1.3
03257032,"Rodenberg, Stadt",03,Niedersachsen,6348,3151,3197,623,423,200,951,722,229,9.8,6.7,3.2,15.0,11.4,3.6
03257004,Auhagen,03,Niedersachsen,1274,646,628,117,86,31,44,32,12,9.2,6.8,2.4,3.5,2.5,0.9
03257010,"Hagenburg, Flecken",03,Niedersachsen,4494,2196,2298,399,286,113,251,184,67,8.9,6.4,2.5,5.6,4.1,1.5
03257033,"Sachsenhagen, Stadt",03,Niedersachsen,1911,959,952,159,115,44,137,85,52,8.3,6.0,2.3,7.2,4.4,2.7
03257038,Wölpinghausen,03,Niedersachsen,1574,787,787,127,95,32,83,64,19,8.1,6.0,2.0,5.3,4.1,1.2
03351004,"Bergen, Stadt",03,Niedersachsen,13027,6470,6557,1459,953,506,1057,668,389,11.2,7.3,3.9,8.1,5.1,3.0
03351006,"Celle, Stadt",03,Niedersachsen,69748,33812,35936,5853,3949,1904,6992,4844,2148,8.4,5.7,2.7,10.0,6.9,3.1
03351010,Faßberg,03,Niedersachsen,6142,3131,3011,583,395,188,365,255,110,9.5,6.4,3.1,5.9,4.2,1.8
03351012,Hambühren,03,Niedersachsen,10227,5151,5076,868,591,277,776,498,278,8.5,5.8,2.7,7.6,4.9,2.7
03351023,Wietze,03,Niedersachsen,8096,4006,4090,664,461,203,489,338,151,8.2,5.7,2.5,6.0,4.2,1.9
03351024,Winsen (Aller),03,Niedersachsen,13017,6424,6593,1186,826,360,1237,929,308,9.1,6.3,2.8,9.5,7.1,2.4
03351025,Eschede,03,Niedersachsen,5926,2959,2967,540,377,163,320,222,98,9.1,6.4,2.8,5.4,3.7,1.7
03351026,Südheide,03,Niedersachsen,11652,5754,5898,1068,749,319,975,627,348,9.2,6.4,2.7,8.4,5.4,3.0
03351005,Bröckel,03,Niedersachsen,1778,879,899,157,88,69,109,64,45,8.8,4.9,3.9,6.1,3.6,2.5
03351007,Eicklingen,03,Niedersachsen,3202,1594,1608,296,220,76,266,190,76,9.2,6.9,2.4,8.3,5.9,2.4
03351017,Langlingen,03,Niedersachsen,2179,1067,1112,224,165,59,150,114,36,10.3,7.6,2.7,6.9,5.2,1.7
03351022,"Wienhausen, Klostergemeinde",03,Niedersachsen,4159,2028,2131,317,225,92,231,166,65,7.6,5.4,2.2,5.6,4.0,1.6
03351002,Ahnsbeck,03,Niedersachsen,1654,823,831,175,120,55,-1,-1,-1,10.6,7.3,3.3,-0.1,,
03351003,Beedenbostel,03,Niedersachsen,993,492,501,99,61,38,97,57,40,10.0,6.1,3.8,9.8,5.7,4.0
03351008,Eldingen,03,Niedersachsen,2020,989,1031,171,120,51,97,56,41,8.5,5.9,2.5,4.8,2.8,2.0
03351015,Hohne,03,Niedersachsen,1679,866,813,154,101,53,104,61,43,9.2,6.0,3.2,6.2,3.6,2.6
03351016,Lachendorf,03,Niedersachsen,6147,3014,3133,543,379,164,413,298,115,8.8,6.2,2.7,6.7,4.8,1.9
03351001,Adelheidsdorf,03,Niedersachsen,2601,1297,1304,225,131,94,138,88,50,8.7,5.0,3.6,5.3,3.4,1.9
03351018,Nienhagen,03,Niedersachsen,6793,3333,3460,585,414,171,471,313,158,8.6,6.1,2.5,6.9,4.6,2.3
03351021,Wathlingen,03,Niedersachsen,6153,3068,3085,592,429,163,327,234,93,9.6,7.0,2.6,5.3,3.8,1.5
03351501,"Lohheide, gemfr. Bezirk",03,Niedersachsen,778,386,392,67,40,27,-1,-1,-1,8.6,5.1,3.5,-0.1,,
03352011,"Cuxhaven, Stadt",03,Niedersachsen,48264,22847,25417,5184,3320,1864,5220,3406,1814,10.7,6.9,3.9,10.8,7.1,3.8
03352032,Loxstedt,03,Niedersachsen,15980,7925,8055,1512,1028,484,974,652,322,9.5,6.4,3.0,6.1,4.1,2.0
03352050,Schiffdorf,03,Niedersachsen,14095,6978,7117,1243,854,389,1130,808,322,8.8,6.1,2.8,8.0,5.7,2.3
03352059,Beverstedt,03,Niedersachsen,13503,6769,6734,1399,969,430,1029,743,286,10.4,7.2,3.2,7.6,5.5,2.1
03352060,Hagen im Bremischen,03,Niedersachsen,10991,5490,5501,1159,808,351,1087,756,331,10.5,7.4,3.2,9.9,6.9,3.0
03352061,Wurster Nordseeküste,03,Niedersachsen,16965,8508,8457,1750,1213,537,1398,941,457,10.3,7.2,3.2,8.2,5.5,2.7
03352062,"Geestland, Stadt",03,Niedersachsen,30936,15094,15842,2956,2002,954,2409,1669,740,9.6,6.5,3.1,7.8,5.4,2.4
03352004,Belum,03,Niedersachsen,838,418,420,80,65,15,31,19,12,9.5,7.8,1.8,3.7,2.3,1.4
03352008,Bülkau,03,Niedersachsen,884,435,449,91,64,27,65,46,19,10.3,7.2,3.1,7.4,5.2,2.1
03352009,Cadenberge,03,Niedersachsen,3400,1644,1756,373,266,107,364,274,90,11.0,7.8,3.1,10.7,8.1,2.6
03352018,Geversdorf,03,Niedersachsen,726,367,359,74,54,20,28,19,9,10.2,7.4,2.8,3.9,2.6,1.2
03352039,"Neuhaus (Oste), Flecken",03,Niedersachsen,1186,595,591,123,77,46,82,48,34,10.4,6.5,3.9,6.9,4.0,2.9
03352042,Oberndorf,03,Niedersachsen,1359,696,663,119,86,33,94,65,29,8.8,6.3,2.4,6.9,4.8,2.1
03352056,Wingst,03,Niedersachsen,3414,1699,1715,321,222,99,257,194,63,9.4,6.5,2.9,7.5,5.7,1.8
03352002,Armstorf,03,Niedersachsen,646,330,316,83,58,25,64,42,22,12.8,9.0,3.9,9.9,6.5,3.4
03352024,Hollnseth,03,Niedersachsen,898,459,439,106,75,31,48,27,21,11.8,8.4,3.5,5.3,3.0,2.3
03352029,Lamstedt,03,Niedersachsen,3349,1633,1716,315,228,87,332,231,101,9.4,6.8,2.6,9.9,6.9,3.0
03352036,Mittelstenahe,03,Niedersachsen,601,294,307,63,48,15,26,17,9,10.5,8.0,2.5,4.3,2.8,1.5
03352052,Stinstedt,03,Niedersachsen,558,294,264,57,42,15,26,18,8,10.2,7.5,2.7,4.7,3.2,1.4
03352020,Hechthausen,03,Niedersachsen,3500,1779,1721,324,246,78,174,138,36,9.3,7.0,2.2,5.0,3.9,1.0
03352022,"Hemmoor, Stadt",03,Niedersachsen,8861,4319,4542,856,634,222,839,629,210,9.7,7.2,2.5,9.5,7.1,2.4
03352044,Osten,03,Niedersachsen,1828,911,917,164,137,27,125,86,39,9.0,7.5,1.5,6.8,4.7,2.1
03352025,Ihlienworth,03,Niedersachsen,1588,801,787,141,106,35,94,70,24,8.9,6.7,2.2,5.9,4.4,1.5
03352038,Neuenkirchen,03,Niedersachsen,1378,708,670,122,81,41,58,38,20,8.9,5.9,3.0,4.2,2.8,1.5
03352041,Nordleda,03,Niedersachsen,1084,566,518,115,91,24,31,27,4,10.6,8.4,2.2,2.9,2.5,0.4
03352043,Odisheim,03,Niedersachsen,497,277,220,51,39,12,-1,-1,-1,10.3,7.8,2.4,-0.2,,
03352045,Osterbruch,03,Niedersachsen,520,256,264,45,39,6,-1,-1,-1,8.7,7.5,1.2,-0.2,,
03352046,"Otterndorf, Stadt",03,Niedersachsen,7230,3448,3782,744,472,272,1074,759,315,10.3,6.5,3.8,14.9,10.5,4.4
03352051,Steinau,03,Niedersachsen,845,435,410,85,62,23,29,21,8,10.1,7.3,2.7,3.4,2.5,0.9
03352055,Wanna,03,Niedersachsen,2179,1089,1090,220,155,65,124,77,47,10.1,7.1,3.0,5.7,3.5,2.2
03353005,"Buchholz in der Nordheide, Stadt",03,Niedersachsen,38487,18426,20061,3581,2436,1145,3303,2269,1034,9.3,6.3,3.0,8.6,5.9,2.7
03353026,Neu Wulmstorf,03,Niedersachsen,20828,10412,10416,1890,1265,625,1457,985,472,9.1,6.1,3.0,7.0,4.7,2.3
03353029,Rosengarten,03,Niedersachsen,13337,6581,6756,1252,842,410,956,675,281,9.4,6.3,3.1,7.2,5.1,2.1
03353031,Seevetal,03,Niedersachsen,40949,20043,20906,3663,2382,1281,3246,2046,1200,8.9,5.8,3.1,7.9,5.0,2.9
03353032,Stelle,03,Niedersachsen,11086,5557,5529,1069,693,376,721,432,289,9.6,6.3,3.4,6.5,3.9,2.6
03353040,"Winsen (Luhe), Stadt",03,Niedersachsen,33896,16591,17305,3411,2238,1173,3392,2297,1095,10.1,6.6,3.5,10.0,6.8,3.2
03353007,Drage,03,Niedersachsen,4205,2131,2074,397,276,121,217,130,87,9.4,6.6,2.9,5.2,3.1,2.1
03353023,Marschacht,03,Niedersachsen,3859,1936,1923,342,206,136,298,183,115,8.9,5.3,3.5,7.7,4.7,3.0
03353033,Tespe,03,Niedersachsen,4318,2204,2114,352,234,118,147,90,57,8.2,5.4,2.7,3.4,2.1,1.3
03353002,Asendorf,03,Niedersachsen,1882,923,959,182,127,55,58,39,19,9.7,6.7,2.9,3.1,2.1,1.0
03353004,Brackel,03,Niedersachsen,1827,923,904,174,108,66,135,71,64,9.5,5.9,3.6,7.4,3.9,3.5
03353009,Egestorf,03,Niedersachsen,2509,1237,1272,218,137,81,155,111,44,8.7,5.5,3.2,6.2,4.4,1.8
03353016,Hanstedt,03,Niedersachsen,5438,2606,2832,567,372,195,787,531,256,10.4,6.8,3.6,14.5,9.8,4.7
03353024,Marxen,03,Niedersachsen,1535,789,746,128,83,45,106,61,45,8.3,5.4,2.9,6.9,4.0,2.9
03353036,Undeloh,03,Niedersachsen,958,488,470,113,69,44,59,35,24,11.8,7.2,4.6,6.2,3.7,2.5
03353001,Appel,03,Niedersachsen,1936,980,956,171,115,56,110,81,29,8.8,5.9,2.9,5.7,4.2,1.5
03353008,Drestedt,03,Niedersachsen,791,394,397,61,36,25,-1,-1,-1,7.7,4.6,3.2,-0.1,,
03353014,Halvesbostel,03,Niedersachsen,763,388,375,88,58,30,82,37,45,11.5,7.6,3.9,10.7,4.8,5.9
03353019,Hollenstedt,03,Niedersachsen,3609,1792,1817,350,224,126,426,278,148,9.7,6.2,3.5,11.8,7.7,4.1
03353025,Moisburg,03,Niedersachsen,1898,951,947,200,137,63,114,82,32,10.5,7.2,3.3,6.0,4.3,1.7
03353028,Regesbostel,03,Niedersachsen,1066,529,537,98,66,32,33,18,15,9.2,6.2,3.0,3.1,1.7,1.4
03353039,Wenzendorf,03,Niedersachsen,1343,654,689,152,94,58,146,83,63,11.3,7.0,4.3,10.9,6.2,4.7
03353003,Bendestorf,03,Niedersachsen,2337,1121,1216,182,120,62,143,105,38,7.8,5.1,2.7,6.1,4.5,1.6
03353017,Harmstorf,03,Niedersachsen,868,403,465,74,49,25,33,21,12,8.5,5.6,2.9,3.8,2.4,1.4
03353020,Jesteburg,03,Niedersachsen,7883,3882,4001,693,449,244,602,396,206,8.8,5.7,3.1,7.6,5.0,2.6
03353010,Eyendorf,03,Niedersachsen,1230,599,631,137,99,38,49,34,15,11.1,8.0,3.1,4.0,2.8,1.2
03353011,Garlstorf,03,Niedersachsen,1135,598,537,124,76,48,61,43,18,10.9,6.7,4.2,5.4,3.8,1.6
03353012,Garstedt,03,Niedersachsen,1447,712,735,160,107,53,88,64,24,11.1,7.4,3.7,6.1,4.4,1.7
03353013,Gödenstorf,03,Niedersachsen,968,480,488,109,63,46,54,29,25,11.3,6.5,4.8,5.6,3.0,2.6
03353030,Salzhausen,03,Niedersachsen,4787,2366,2421,491,351,140,538,383,155,10.3,7.3,2.9,11.2,8.0,3.2
03353034,Toppenstedt,03,Niedersachsen,2176,1105,1071,207,138,69,117,72,45,9.5,6.3,3.2,5.4,3.3,2.1
03353037,Vierhöfen,03,Niedersachsen,957,455,502,83,49,34,48,32,16,8.7,5.1,3.6,5.0,3.3,1.7
03353042,Wulfsen,03,Niedersachsen,1671,828,843,145,96,49,85,47,38,8.7,5.7,2.9,5.1,2.8,2.3
03353006,Dohren,03,Niedersachsen,1156,593,563,116,80,36,-1,-1,-1,10.0,6.9,3.1,-0.1,,
03353015,Handeloh,03,Niedersachsen,2411,1206,1205,235,173,62,176,122,54,9.7,7.2,2.6,7.3,5.1,2.2
03353018,Heidenau,03,Niedersachsen,2255,1166,1089,226,145,81,108,66,42,10.0,6.4,3.6,4.8,2.9,1.9
03353021,Kakenstorf,03,Niedersachsen,1352,669,683,116,75,41,111,58,53,8.6,5.5,3.0,8.2,4.3,3.9
03353022,Königsmoor,03,Niedersachsen,625,332,293,62,35,27,27,16,11,9.9,5.6,4.3,4.3,2.6,1.8
03353027,Otter,03,Niedersachsen,1716,894,822,148,99,49,54,38,16,8.6,5.8,2.9,3.1,2.2,0.9
03353035,Tostedt,03,Niedersachsen,13704,6661,7043,1299,879,420,1164,822,342,9.5,6.4,3.1,8.5,6.0,2.5
03353038,Welle,03,Niedersachsen,1209,629,580,127,83,44,97,60,37,10.5,6.9,3.6,8.0,5.0,3.1
03353041,Wistedt,03,Niedersachsen,1715,855,860,181,118,63,64,42,22,10.6,6.9,3.7,3.7,2.4,1.3
03354005,"Gartow, Flecken",03,Niedersachsen,1397,655,742,103,77,26,119,93,26,7.4,5.5,1.9,8.5,6.7,1.9
03354007,Gorleben,03,Niedersachsen,625,312,313,52,36,16,39,30,9,8.3,5.8,2.6,6.2,4.8,1.4
03354010,Höhbeck,03,Niedersachsen,656,325,331,41,34,7,35,23,12,6.2,5.2,1.1,5.3,3.5,1.8
03354020,Prezelle,03,Niedersachsen,439,220,219,31,24,7,20,-1,-1,7.1,5.5,1.6,4.6,,
03354021,"Schnackenburg, Stadt",03,Niedersachsen,564,284,280,48,38,10,25,20,5,8.5,6.7,1.8,4.4,3.5,0.9
03354003,Damnatz,03,Niedersachsen,294,141,153,20,15,5,30,18,12,6.8,5.1,1.7,10.2,6.1,4.1
03354004,"Dannenberg (Elbe), Stadt",03,Niedersachsen,8932,4623,4309,647,430,217,872,567,305,7.2,4.8,2.4,9.8,6.3,3.4
03354006,Göhrde,03,Niedersachsen,611,293,318,50,35,15,58,43,15,8.2,5.7,2.5,9.5,7.0,2.5
03354008,Gusborn,03,Niedersachsen,1204,611,593,88,59,29,34,23,11,7.3,4.9,2.4,2.8,1.9,0.9
03354009,"Hitzacker (Elbe), Stadt",03,Niedersachsen,4904,2334,2570,411,289,122,353,254,99,8.4,5.9,2.5,7.2,5.2,2.0
03354011,Jameln,03,Niedersachsen,1028,520,508,81,56,25,67,43,24,7.9,5.4,2.4,6.5,4.2,2.3
03354012,Karwitz,03,Niedersachsen,745,368,377,67,48,19,25,19,6,9.0,6.4,2.6,3.4,2.6,0.8
03354014,Langendorf,03,Niedersachsen,676,324,352,61,52,9,18,15,3,9.0,7.7,1.3,2.7,2.2,0.4
03354019,Neu Darchau,03,Niedersachsen,1393,662,731,71,48,23,59,45,14,5.1,3.4,1.7,4.2,3.2,1.0
03354027,Zernien,03,Niedersachsen,1638,798,840,137,95,42,105,51,54,8.4,5.8,2.6,6.4,3.1,3.3
03354001,"Bergen an der Dumme, Flecken",03,Niedersachsen,1595,815,780,114,76,38,86,63,23,7.1,4.8,2.4,5.4,3.9,1.4
03354002,"Clenze, Flecken",03,Niedersachsen,2382,1208,1174,174,126,48,144,97,47,7.3,5.3,2.0,6.0,4.1,2.0
03354013,Küsten,03,Niedersachsen,1363,662,701,105,69,36,84,63,21,7.7,5.1,2.6,6.2,4.6,1.5
03354015,Lemgow,03,Niedersachsen,1390,700,690,102,72,30,55,34,21,7.3,5.2,2.2,4.0,2.4,1.5
03354016,Luckau (Wendland),03,Niedersachsen,631,341,290,62,39,23,43,21,22,9.8,6.2,3.6,6.8,3.3,3.5
03354017,Lübbow,03,Niedersachsen,822,422,400,59,43,16,17,-1,-1,7.2,5.2,1.9,2.1,,
03354018,"Lüchow (Wendland), Stadt",03,Niedersachsen,9481,4616,4865,748,558,190,1057,803,254,7.9,5.9,2.0,11.1,8.5,2.7
03354022,Schnega,03,Niedersachsen,1320,636,684,98,75,23,63,49,14,7.4,5.7,1.7,4.8,3.7,1.1
03354023,Trebel,03,Niedersachsen,1002,497,505,62,42,20,50,28,22,6.2,4.2,2.0,5.0,2.8,2.2
03354024,Waddeweitz,03,Niedersachsen,942,451,491,55,39,16,43,30,13,5.8,4.1,1.7,4.6,3.2,1.4
03354025,Woltersdorf,03,Niedersachsen,1228,718,510,79,55,24,22,16,6,6.4,4.5,2.0,1.8,1.3,0.5
03354026,"Wustrow (Wendland), Stadt",03,Niedersachsen,2866,1455,1411,196,145,51,112,81,31,6.8,5.1,1.8,3.9,2.8,1.1
03355001,Adendorf,03,Niedersachsen,10724,5112,5612,916,596,320,782,487,295,8.5,5.6,3.0,7.3,4.5,2.8
03355009,"Bleckede, Stadt",03,Niedersachsen,9439,4601,4838,731,507,224,497,347,150,7.7,5.4,2.4,5.3,3.7,1.6
03355022,"Lüneburg, Hansestadt",03,Niedersachsen,74072,35664,38408,6558,4532,2026,8887,6120,2767,8.9,6.1,2.7,12.0,8.3,3.7
03355049,Amt Neuhaus,03,Niedersachsen,5127,2627,2500,283,213,70,184,134,50,5.5,4.2,1.4,3.6,2.6,1.0
03355002,Amelinghausen,03,Niedersachsen,4062,2016,2046,398,263,135,313,223,90,9.8,6.5,3.3,7.7,5.5,2.2
03355008,Betzendorf,03,Niedersachsen,1125,551,574,95,61,34,96,70,26,8.4,5.4,3.0,8.5,6.2,2.3
03355027,Oldendorf (Luhe),03,Niedersachsen,1010,507,503,105,73,32,59,45,14,10.4,7.2,3.2,5.8,4.5,1.4
03355029,Rehlingen,03,Niedersachsen,743,374,369,181,135,46,32,21,11,24.4,18.2,6.2,4.3,2.8,1.5
03355034,Soderstorf,03,Niedersachsen,1413,703,710,145,105,40,89,60,29,10.3,7.4,2.8,6.3,4.2,2.1
03355004,"Bardowick, Flecken",03,Niedersachsen,6867,3352,3515,632,395,237,518,335,183,9.2,5.8,3.5,7.5,4.9,2.7
03355007,Barum,03,Niedersachsen,1911,979,932,158,103,55,85,56,29,8.3,5.4,2.9,4.4,2.9,1.5
03355017,Handorf,03,Niedersachsen,1981,999,982,178,106,72,126,78,48,9.0,5.4,3.6,6.4,3.9,2.4
03355023,Mechtersen,03,Niedersachsen,691,335,356,49,34,15,31,19,12,7.1,4.9,2.2,4.5,2.7,1.7
03355028,Radbruch,03,Niedersachsen,2047,1030,1017,159,99,60,80,47,33,7.8,4.8,2.9,3.9,2.3,1.6
03355039,Vögelsen,03,Niedersachsen,2345,1137,1208,165,112,53,104,64,40,7.0,4.8,2.3,4.4,2.7,1.7
03355042,Wittorf,03,Niedersachsen,1471,751,720,117,73,44,91,70,21,8.0,5.0,3.0,6.2,4.8,1.4
03355010,Boitze,03,Niedersachsen,391,201,190,40,28,12,-1,-1,-1,10.2,7.2,3.1,-0.3,,
03355012,Dahlem,03,Niedersachsen,599,329,270,35,23,12,26,19,7,5.8,3.8,2.0,4.3,3.2,1.2
03355013,"Dahlenburg, Flecken",03,Niedersachsen,3313,1703,1610,270,195,75,249,181,68,8.1,5.9,2.3,7.5,5.5,2.1
03355025,Nahrendorf,03,Niedersachsen,1253,631,622,112,85,27,47,32,15,8.9,6.8,2.2,3.8,2.6,1.2
03355037,Tosterglope,03,Niedersachsen,565,282,283,34,24,10,-1,-1,-1,6.0,4.2,1.8,-0.2,,
03355020,Kirchgellersen,03,Niedersachsen,2374,1161,1213,202,126,76,140,77,63,8.5,5.3,3.2,5.9,3.2,2.7
03355031,Reppenstedt,03,Niedersachsen,7234,3466,3768,598,400,198,304,207,97,8.3,5.5,2.7,4.2,2.9,1.3
03355035,Südergellersen,03,Niedersachsen,1630,802,828,135,91,44,141,102,39,8.3,5.6,2.7,8.7,6.3,2.4
03355041,Westergellersen,03,Niedersachsen,1904,948,956,144,101,43,108,80,28,7.6,5.3,2.3,5.7,4.2,1.5
03355006,Barnstedt,03,Niedersachsen,735,354,381,56,48,8,26,19,7,7.6,6.5,1.1,3.5,2.6,1.0
03355014,Deutsch Evern,03,Niedersachsen,3770,1857,1913,326,230,96,217,157,60,8.6,6.1,2.5,5.8,4.2,1.6
03355016,Embsen,03,Niedersachsen,2544,1246,1298,230,137,93,127,75,52,9.0,5.4,3.7,5.0,2.9,2.0
03355024,Melbeck,03,Niedersachsen,3385,1681,1704,331,233,98,173,116,57,9.8,6.9,2.9,5.1,3.4,1.7
03355005,Barendorf,03,Niedersachsen,2566,1292,1274,255,174,81,104,77,27,9.9,6.8,3.2,4.1,3.0,1.1
03355026,Neetze,03,Niedersachsen,2702,1348,1354,209,145,64,183,136,47,7.7,5.4,2.4,6.8,5.0,1.7
03355030,Reinstorf,03,Niedersachsen,1283,621,662,103,65,38,58,35,23,8.0,5.1,3.0,4.5,2.7,1.8
03355036,Thomasburg,03,Niedersachsen,1333,694,639,99,61,38,39,18,21,7.4,4.6,2.9,2.9,1.4,1.6
03355038,Vastorf,03,Niedersachsen,827,454,373,59,33,26,91,35,56,7.1,4.0,3.1,11.0,4.2,6.8
03355040,Wendisch Evern,03,Niedersachsen,1745,851,894,133,83,50,26,15,11,7.6,4.8,2.9,1.5,0.9,0.6
03355003,"Artlenburg, Flecken",03,Niedersachsen,1637,832,805,147,90,57,62,40,22,9.0,5.5,3.5,3.8,2.4,1.3
03355011,Brietlingen,03,Niedersachsen,3476,1742,1734,311,191,120,208,127,81,8.9,5.5,3.5,6.0,3.7,2.3
03355015,Echem,03,Niedersachsen,969,497,472,83,55,28,34,25,9,8.6,5.7,2.9,3.5,2.6,0.9
03355018,Hittbergen,03,Niedersachsen,920,461,459,84,57,27,44,25,19,9.1,6.2,2.9,4.8,2.7,2.1
03355019,Hohnstorf (Elbe),03,Niedersachsen,2423,1205,1218,190,135,55,100,67,33,7.8,5.6,2.3,4.1,2.8,1.4
03355021,Lüdersburg,03,Niedersachsen,647,318,329,61,36,25,52,29,23,9.4,5.6,3.9,8.0,4.5,3.6
03355032,Rullstorf,03,Niedersachsen,1914,936,978,165,103,62,188,166,22,8.6,5.4,3.2,9.8,8.7,1.1
03355033,Scharnebeck,03,Niedersachsen,3552,1798,1754,301,197,104,144,99,45,8.5,5.5,2.9,4.1,2.8,1.3
03356002,Grasberg,03,Niedersachsen,7694,3839,3855,857,564,293,766,469,297,11.1,7.3,3.8,10.0,6.1,3.9
03356005,Lilienthal,03,Niedersachsen,18819,9117,9702,1851,1164,687,1577,1001,576,9.8,6.2,3.7,8.4,5.3,3.1
03356007,"Osterholz-Scharmbeck, Stadt",03,Niedersachsen,30302,14860,15442,3019,1930,1089,2632,1788,844,10.0,6.4,3.6,8.7,5.9,2.8
03356008,Ritterhude,03,Niedersachsen,14680,7226,7454,1309,857,452,1066,729,337,8.9,5.8,3.1,7.3,5.0,2.3
03356009,Schwanewede,03,Niedersachsen,21040,10624,10416,1756,1180,576,1400,988,412,8.3,5.6,2.7,6.7,4.7,2.0
03356011,Worpswede,03,Niedersachsen,9285,4516,4769,999,662,337,853,576,277,10.8,7.1,3.6,9.2,6.2,3.0
03356001,Axstedt,03,Niedersachsen,1153,597,556,105,76,29,36,25,11,9.1,6.6,2.5,3.1,2.2,1.0
03356003,Hambergen,03,Niedersachsen,5705,2786,2919,608,403,205,377,248,129,10.7,7.1,3.6,6.6,4.3,2.3
03356004,Holste,03,Niedersachsen,1326,683,643,138,105,33,52,41,11,10.4,7.9,2.5,3.9,3.1,0.8
03356006,Lübberstedt,03,Niedersachsen,738,382,356,64,42,22,16,7,9,8.7,5.7,3.0,2.2,0.9,1.2
03356010,Vollersode,03,Niedersachsen,2837,1468,1369,322,226,96,195,127,68,11.3,8.0,3.4,6.9,4.5,2.4
03357008,"Bremervörde, Stadt",03,Niedersachsen,18645,9380,9265,1864,1264,600,2182,1500,682,10.0,6.8,3.2,11.7,8.0,3.7
03357016,Gnarrenburg,03,Niedersachsen,9238,4675,4563,1043,728,315,756,521,235,11.3,7.9,3.4,8.2,5.6,2.5
03357039,"Rotenburg (Wümme), Stadt",03,Niedersachsen,21392,10464,10928,2437,1551,886,3449,2203,1246,11.4,7.3,4.1,16.1,10.3,5.8
03357041,Scheeßel,03,Niedersachsen,12946,6535,6411,1488,941,547,1189,792,397,11.5,7.3,4.2,9.2,6.1,3.1
03357051,"Visselhövede, Stadt",03,Niedersachsen,10199,5120,5079,1079,726,353,690,459,231,10.6,7.1,3.5,6.8,4.5,2.3
03357006,Bothel,03,Niedersachsen,2428,1215,1213,283,168,115,148,78,70,11.7,6.9,4.7,6.1,3.2,2.9
03357009,Brockel,03,Niedersachsen,1320,645,675,161,99,62,116,80,36,12.2,7.5,4.7,8.8,6.1,2.7
03357024,Hemsbünde,03,Niedersachsen,1178,584,594,127,68,59,65,40,25,10.8,5.8,5.0,5.5,3.4,2.1
03357025,Hemslingen,03,Niedersachsen,1405,706,699,133,85,48,66,44,22,9.5,6.0,3.4,4.7,3.1,1.6
03357031,Kirchwalsede,03,Niedersachsen,1161,601,560,138,84,54,163,99,64,11.9,7.2,4.7,14.0,8.5,5.5
03357054,Westerwalsede,03,Niedersachsen,739,360,379,74,44,30,24,15,9,10.0,6.0,4.1,3.2,2.0,1.2
03357015,Fintel,03,Niedersachsen,2885,1409,1476,312,204,108,271,174,97,10.8,7.1,3.7,9.4,6.0,3.4
03357023,Helvesiek,03,Niedersachsen,792,413,379,79,44,35,83,43,40,10.0,5.6,4.4,10.5,5.4,5.1
03357033,Lauenbrück,03,Niedersachsen,2266,1138,1128,238,160,78,178,110,68,10.5,7.1,3.4,7.9,4.9,3.0
03357046,Stemmen,03,Niedersachsen,844,446,398,96,54,42,56,34,22,11.4,6.4,5.0,6.6,4.0,2.6
03357049,Vahlde,03,Niedersachsen,674,356,318,80,55,25,50,31,19,11.9,8.2,3.7,7.4,4.6,2.8
03357002,Alfstedt,03,Niedersachsen,864,434,430,118,88,30,99,69,30,13.7,10.2,3.5,11.5,8.0,3.5
03357004,Basdahl,03,Niedersachsen,1430,725,705,175,120,55,86,60,26,12.2,8.4,3.8,6.0,4.2,1.8
03357012,Ebersdorf,03,Niedersachsen,1058,543,515,123,92,31,56,41,15,11.6,8.7,2.9,5.3,3.9,1.4
03357027,Hipstedt,03,Niedersachsen,1237,630,607,138,110,28,72,53,19,11.2,8.9,2.3,5.8,4.3,1.5
03357035,Oerel,03,Niedersachsen,1860,950,910,184,117,67,174,119,55,9.9,6.3,3.6,9.4,6.4,3.0
03357003,Anderlingen,03,Niedersachsen,880,456,424,117,86,31,63,45,18,13.3,9.8,3.5,7.2,5.1,2.0
03357011,Deinstedt,03,Niedersachsen,658,327,331,99,61,38,67,32,35,15.0,9.3,5.8,10.2,4.9,5.3
03357014,Farven,03,Niedersachsen,634,345,289,83,55,28,46,31,15,13.1,8.7,4.4,7.3,4.9,2.4
03357036,Ostereistedt,03,Niedersachsen,914,480,434,108,68,40,103,61,42,11.8,7.4,4.4,11.3,6.7,4.6
03357038,Rhade,03,Niedersachsen,1126,572,554,116,79,37,72,42,30,10.3,7.0,3.3,6.4,3.7,2.7
03357040,Sandbostel,03,Niedersachsen,822,434,388,110,72,38,65,37,28,13.4,8.8,4.6,7.9,4.5,3.4
03357042,Seedorf,03,Niedersachsen,950,610,340,73,44,29,23,12,11,7.7,4.6,3.1,2.4,1.3,1.2
03357043,Selsingen,03,Niedersachsen,3647,1800,1847,444,294,150,378,280,98,12.2,8.1,4.1,10.4,7.7,2.7
03357017,Groß Meckelsen,03,Niedersachsen,466,244,222,53,31,22,44,26,18,11.4,6.7,4.7,9.4,5.6,3.9
03357019,Hamersen,03,Niedersachsen,453,219,234,48,32,16,50,32,18,10.6,7.1,3.5,11.0,7.1,4.0
03357029,Kalbe,03,Niedersachsen,551,282,269,84,52,32,15,11,4,15.2,9.4,5.8,2.7,2.0,0.7
03357032,Klein Meckelsen,03,Niedersachsen,902,454,448,115,69,46,74,51,23,12.7,7.6,5.1,8.2,5.7,2.5
03357034,Lengenbostel,03,Niedersachsen,455,237,218,48,28,20,51,24,27,10.5,6.2,4.4,11.2,5.3,5.9
03357044,Sittensen,03,Niedersachsen,5765,2855,2910,596,385,211,659,462,197,10.3,6.7,3.7,11.4,8.0,3.4
03357048,Tiste,03,Niedersachsen,876,457,419,125,73,52,57,30,27,14.3,8.3,5.9,6.5,3.4,3.1
03357050,Vierden,03,Niedersachsen,768,404,364,79,60,19,33,29,4,10.3,7.8,2.5,4.3,3.8,0.5
03357056,Wohnste,03,Niedersachsen,773,406,367,109,74,35,59,34,25,14.1,9.6,4.5,7.6,4.4,3.2
03357001,Ahausen,03,Niedersachsen,1888,932,956,219,135,84,101,65,36,11.6,7.2,4.4,5.3,3.4,1.9
03357005,Bötersen,03,Niedersachsen,1070,542,528,121,76,45,72,43,29,11.3,7.1,4.2,6.7,4.0,2.7
03357020,Hassendorf,03,Niedersachsen,1120,576,544,139,89,50,22,12,10,12.4,7.9,4.5,2.0,1.1,0.9
03357022,Hellwege,03,Niedersachsen,1041,514,527,122,77,45,64,45,19,11.7,7.4,4.3,6.1,4.3,1.8
03357028,Horstedt,03,Niedersachsen,1293,675,618,193,130,63,107,72,35,14.9,10.1,4.9,8.3,5.6,2.7
03357037,Reeßum,03,Niedersachsen,1679,839,840,187,132,55,82,55,27,11.1,7.9,3.3,4.9,3.3,1.6
03357045,Sottrum,03,Niedersachsen,6353,3134,3219,653,457,196,809,574,235,10.3,7.2,3.1,12.7,9.0,3.7
03357007,Breddorf,03,Niedersachsen,1065,561,504,147,97,50,121,76,45,13.8,9.1,4.7,11.4,7.1,4.2
03357010,Bülstedt,03,Niedersachsen,753,388,365,102,67,35,69,44,25,13.5,8.9,4.6,9.2,5.8,3.3
03357026,Hepstedt,03,Niedersachsen,987,502,485,127,92,35,52,38,14,12.9,9.3,3.5,5.3,3.9,1.4
03357030,Kirchtimke,03,Niedersachsen,974,487,487,128,85,43,86,53,33,13.1,8.7,4.4,8.8,5.4,3.4
03357047,Tarmstedt,03,Niedersachsen,3819,1922,1897,463,285,178,298,194,104,12.1,7.5,4.7,7.8,5.1,2.7
03357052,Vorwerk,03,Niedersachsen,1029,531,498,125,86,39,52,27,25,12.1,8.4,3.8,5.1,2.6,2.4
03357053,Westertimke,03,Niedersachsen,431,223,208,73,46,27,60,33,27,16.9,10.7,6.3,13.9,7.7,6.3
03357055,Wilstedt,03,Niedersachsen,1738,883,855,203,139,64,192,130,62,11.7,8.0,3.7,11.0,7.5,3.6
03357013,Elsdorf,03,Niedersachsen,2046,1053,993,283,191,92,172,106,66,13.8,9.3,4.5,8.4,5.2,3.2
03357018,Gyhum,03,Niedersachsen,2250,1150,1100,271,157,114,366,185,181,12.0,7.0,5.1,16.3,8.2,8.0
03357021,Heeslingen,03,Niedersachsen,4756,2401,2355,509,340,169,696,538,158,10.7,7.1,3.6,14.6,11.3,3.3
03357057,"Zeven, Stadt",03,Niedersachsen,13760,7005,6755,1706,1107,599,1957,1237,720,12.4,8.0,4.4,14.2,9.0,5.2
03358002,Bispingen,03,Niedersachsen,6404,3187,3217,703,489,214,801,537,264,11.0,7.6,3.3,12.5,8.4,4.1
03358004,Bomlitz,03,Niedersachsen,6951,3452,3499,681,450,231,378,253,125,9.8,6.5,3.3,5.4,3.6,1.8
03358008,"Bad Fallingbostel, Stadt",03,Niedersachsen,11044,5425,5619,1142,781,361,1253,902,351,10.3,7.1,3.3,11.3,8.2,3.2
03358016,"Munster, Stadt",03,Niedersachsen,15091,7799,7292,1610,1131,479,1303,913,390,10.7,7.5,3.2,8.6,6.0,2.6
03358017,Neuenkirchen,03,Niedersachsen,5570,2790,2780,619,437,182,401,284,117,11.1,7.8,3.3,7.2,5.1,2.1
03358019,"Schneverdingen, Stadt",03,Niedersachsen,18729,9145,9584,1921,1340,581,2055,1347,708,10.3,7.2,3.1,11.0,7.2,3.8
03358021,"Soltau, Stadt",03,Niedersachsen,21414,10456,10958,2277,1545,732,2697,1852,845,10.6,7.2,3.4,12.6,8.6,3.9
03358022,"Walsrode, Stadt",03,Niedersachsen,23219,11453,11766,2373,1632,741,2520,1743,777,10.2,7.0,3.2,10.9,7.5,3.3
03358023,Wietzendorf,03,Niedersachsen,4105,2050,2055,415,288,127,358,253,105,10.1,7.0,3.1,8.7,6.2,2.6
03358001,"Ahlden (Aller), Flecken",03,Niedersachsen,1518,770,748,154,113,41,87,61,26,10.1,7.4,2.7,5.7,4.0,1.7
03358006,Eickeloh,03,Niedersachsen,781,400,381,83,62,21,39,31,8,10.6,7.9,2.7,5.0,4.0,1.0
03358011,Grethem,03,Niedersachsen,646,306,340,59,45,14,31,22,9,9.1,7.0,2.2,4.8,3.4,1.4
03358012,Hademstorf,03,Niedersachsen,834,414,420,91,68,23,-1,-1,-1,10.9,8.2,2.8,-0.1,,
03358014,Hodenhagen,03,Niedersachsen,3255,1667,1588,340,230,110,475,329,146,10.4,7.1,3.4,14.6,10.1,4.5
03358003,Böhme,03,Niedersachsen,920,483,437,105,78,27,98,68,30,11.4,8.5,2.9,10.7,7.4,3.3
03358009,Frankenfeld,03,Niedersachsen,522,254,268,46,36,10,36,22,14,8.8,6.9,1.9,6.9,4.2,2.7
03358013,Häuslingen,03,Niedersachsen,795,425,370,107,61,46,72,42,30,13.5,7.7,5.8,9.1,5.3,3.8
03358018,"Rethem (Aller), Stadt",03,Niedersachsen,2357,1160,1197,286,206,80,236,175,61,12.1,8.7,3.4,10.0,7.4,2.6
03358005,Buchholz (Aller),03,Niedersachsen,2133,1092,1041,178,119,59,230,167,63,8.3,5.6,2.8,10.8,7.8,3.0
03358007,Essel,03,Niedersachsen,1100,577,523,107,70,37,65,39,26,9.7,6.4,3.4,5.9,3.5,2.4
03358010,Gilten,03,Niedersachsen,1205,622,583,113,82,31,62,43,19,9.4,6.8,2.6,5.1,3.6,1.6
03358015,Lindwedel,03,Niedersachsen,2618,1328,1290,234,147,87,110,80,30,8.9,5.6,3.3,4.2,3.1,1.1
03358020,Schwarmstedt,03,Niedersachsen,5489,2662,2827,577,414,163,561,406,155,10.5,7.5,3.0,10.2,7.4,2.8
03358501,"Osterheide, gemfr. Bezirk",03,Niedersachsen,3564,2454,1110,64,42,22,-1,-1,-1,1.8,1.2,0.6,-0.0,,
03359010,"Buxtehude, Hansestadt",03,Niedersachsen,40173,20120,20053,3461,2278,1183,5069,3676,1393,8.6,5.7,2.9,12.6,9.2,3.5
03359013,Drochtersen,03,Niedersachsen,11292,5595,5697,1157,853,304,772,514,258,10.2,7.6,2.7,6.8,4.6,2.3
03359028,Jork,03,Niedersachsen,12050,6174,5876,1132,785,347,1107,765,342,9.4,6.5,2.9,9.2,6.3,2.8
03359038,"Stade, Hansestadt",03,Niedersachsen,46378,22598,23780,4280,2924,1356,5516,3899,1617,9.2,6.3,2.9,11.9,8.4,3.5
03359003,Apensen,03,Niedersachsen,3945,2032,1913,343,244,99,240,184,56,8.7,6.2,2.5,6.1,4.7,1.4
03359006,Beckdorf,03,Niedersachsen,2660,1357,1303,255,170,85,111,73,38,9.6,6.4,3.2,4.2,2.7,1.4
03359037,Sauensiek,03,Niedersachsen,2353,1163,1190,228,155,73,133,79,54,9.7,6.6,3.1,5.7,3.4,2.3
03359011,Deinste,03,Niedersachsen,1999,1020,979,213,135,78,156,89,67,10.7,6.8,3.9,7.8,4.5,3.4
03359017,Fredenbeck,03,Niedersachsen,6072,3061,3011,581,401,180,414,282,132,9.6,6.6,3.0,6.8,4.6,2.2
03359031,Kutenholz,03,Niedersachsen,4633,2330,2303,420,286,134,199,125,74,9.1,6.2,2.9,4.3,2.7,1.6
03359002,Ahlerstedt,03,Niedersachsen,5273,2663,2610,652,450,202,490,320,170,12.4,8.5,3.8,9.3,6.1,3.2
03359005,Bargstedt,03,Niedersachsen,1987,1026,961,224,164,60,178,122,56,11.3,8.3,3.0,9.0,6.1,2.8
03359008,Brest,03,Niedersachsen,795,417,378,98,72,26,40,32,8,12.3,9.1,3.3,5.0,4.0,1.0
03359023,"Harsefeld, Flecken",03,Niedersachsen,12874,6376,6498,1338,904,434,994,679,315,10.4,7.0,3.4,7.7,5.3,2.4
03359001,Agathenburg,03,Niedersachsen,1180,587,593,94,68,26,47,26,21,8.0,5.8,2.2,4.0,2.2,1.8
03359007,Bliedersdorf,03,Niedersachsen,1717,889,828,164,117,47,59,45,14,9.6,6.8,2.7,3.4,2.6,0.8
03359012,Dollern,03,Niedersachsen,2034,1040,994,194,138,56,259,193,66,9.5,6.8,2.8,12.7,9.5,3.2
03359027,"Horneburg, Flecken",03,Niedersachsen,6026,2995,3031,488,351,137,336,242,94,8.1,5.8,2.3,5.6,4.0,1.6
03359034,Nottensdorf,03,Niedersachsen,1431,710,721,111,72,39,121,82,39,7.8,5.0,2.7,8.5,5.7,2.7
03359020,Grünendeich,03,Niedersachsen,1871,931,940,188,129,59,122,79,43,10.0,6.9,3.2,6.5,4.2,2.3
03359021,Guderhandviertel,03,Niedersachsen,1111,550,561,111,77,34,95,71,24,10.0,6.9,3.1,8.6,6.4,2.2
03359026,Hollern-Twielenfleth,03,Niedersachsen,3360,1719,1641,315,206,109,239,168,71,9.4,6.1,3.2,7.1,5.0,2.1
03359032,Mittelnkirchen,03,Niedersachsen,1076,573,503,95,72,23,54,35,19,8.8,6.7,2.1,5.0,3.3,1.8
03359033,Neuenkirchen,03,Niedersachsen,838,419,419,70,45,25,28,17,11,8.4,5.4,3.0,3.3,2.0,1.3
03359039,Steinkirchen,03,Niedersachsen,1588,786,802,150,108,42,245,155,90,9.4,6.8,2.6,15.4,9.8,5.7
03359004,Balje,03,Niedersachsen,1017,517,500,116,94,22,104,80,24,11.4,9.2,2.2,10.2,7.9,2.4
03359018,"Freiburg (Elbe), Flecken",03,Niedersachsen,1872,921,951,190,140,50,172,139,33,10.1,7.5,2.7,9.2,7.4,1.8
03359030,Krummendeich,03,Niedersachsen,490,261,229,58,47,11,25,20,5,11.8,9.6,2.2,5.1,4.1,1.0
03359035,Oederquart,03,Niedersachsen,1040,517,523,115,87,28,82,63,19,11.1,8.4,2.7,7.9,6.1,1.8
03359040,Wischhafen,03,Niedersachsen,2956,1535,1421,323,252,71,264,203,61,10.9,8.5,2.4,8.9,6.9,2.1
03359009,Burweg,03,Niedersachsen,1007,511,496,95,61,34,38,24,14,9.4,6.1,3.4,3.8,2.4,1.4
03359014,Düdenbüttel,03,Niedersachsen,990,491,499,109,67,42,68,44,24,11.0,6.8,4.2,6.9,4.4,2.4
03359015,Engelschoff,03,Niedersachsen,763,376,387,60,41,19,33,20,13,7.9,5.4,2.5,4.3,2.6,1.7
03359016,Estorf,03,Niedersachsen,1428,717,711,137,88,49,63,38,25,9.6,6.2,3.4,4.4,2.7,1.8
03359019,Großenwörden,03,Niedersachsen,454,241,213,54,38,16,31,19,12,11.9,8.4,3.5,6.8,4.2,2.6
03359022,Hammah,03,Niedersachsen,3066,1550,1516,305,199,106,159,103,56,9.9,6.5,3.5,5.2,3.4,1.8
03359024,Heinbockel,03,Niedersachsen,1420,726,694,154,96,58,139,76,63,10.8,6.8,4.1,9.8,5.4,4.4
03359025,Himmelpforten,03,Niedersachsen,5127,2547,2580,472,350,122,388,289,99,9.2,6.8,2.4,7.6,5.6,1.9
03359029,Kranenburg,03,Niedersachsen,726,374,352,69,52,17,35,29,6,9.5,7.2,2.3,4.8,4.0,0.8
03359036,Oldendorf,03,Niedersachsen,2982,1479,1503,286,202,84,127,81,46,9.6,6.8,2.8,4.3,2.7,1.5
03360004,Bienenbüttel,03,Niedersachsen,6644,3299,3345,530,336,194,375,253,122,8.0,5.1,2.9,5.6,3.8,1.8
03360025,"Uelzen, Stadt",03,Niedersachsen,33782,16475,17307,2827,1908,919,3438,2325,1113,8.4,5.6,2.7,10.2,6.9,3.3
03360015,Oetzen,03,Niedersachsen,1169,590,579,102,69,33,42,25,17,8.7,5.9,2.8,3.6,2.1,1.5
03360016,Rätzlingen,03,Niedersachsen,467,231,236,34,21,13,-1,-1,-1,7.3,4.5,2.8,-0.2,,
03360018,Rosche,03,Niedersachsen,2036,1005,1031,181,124,57,143,108,35,8.9,6.1,2.8,7.0,5.3,1.7
03360022,Stoetze,03,Niedersachsen,589,295,294,53,35,18,34,19,15,9.0,5.9,3.1,5.8,3.2,2.5
03360024,Suhlendorf,03,Niedersachsen,2510,1236,1274,182,131,51,139,104,35,7.3,5.2,2.0,5.5,4.1,1.4
03360007,Eimke,03,Niedersachsen,812,422,390,86,62,24,68,52,16,10.6,7.6,3.0,8.4,6.4,2.0
03360009,Gerdau,03,Niedersachsen,1449,742,707,124,84,40,120,82,38,8.6,5.8,2.8,8.3,5.7,2.6
03360023,Suderburg,03,Niedersachsen,4549,2265,2284,455,334,121,318,239,79,10.0,7.3,2.7,7.0,5.3,1.7
03360001,Altenmedingen,03,Niedersachsen,1555,757,798,130,84,46,59,41,18,8.4,5.4,3.0,3.8,2.6,1.2
03360002,"Bad Bevensen, Stadt",03,Niedersachsen,9060,4170,4890,723,481,242,890,592,298,8.0,5.3,2.7,9.8,6.5,3.3
03360003,Barum,03,Niedersachsen,788,385,403,71,43,28,71,37,34,9.0,5.5,3.6,9.0,4.7,4.3
03360006,"Ebstorf,Klosterflecken",03,Niedersachsen,5396,2666,2730,444,303,141,291,197,94,8.2,5.6,2.6,5.4,3.7,1.7
03360008,Emmendorf,03,Niedersachsen,731,358,373,77,52,25,-1,-1,-1,10.5,7.1,3.4,-0.1,,
03360010,Hanstedt,03,Niedersachsen,891,456,435,79,55,24,125,98,27,8.9,6.2,2.7,14.0,11.0,3.0
03360011,Himbergen,03,Niedersachsen,1709,868,841,143,100,43,78,52,26,8.4,5.9,2.5,4.6,3.0,1.5
03360012,Jelmstorf,03,Niedersachsen,770,390,380,74,53,21,32,16,16,9.6,6.9,2.7,4.2,2.1,2.1
03360014,Natendorf,03,Niedersachsen,756,373,383,68,45,23,65,40,25,9.0,6.0,3.0,8.6,5.3,3.3
03360017,Römstedt,03,Niedersachsen,779,383,396,66,46,20,49,37,12,8.5,5.9,2.6,6.3,4.7,1.5
03360019,Schwienau,03,Niedersachsen,706,362,344,79,46,33,44,19,25,11.2,6.5,4.7,6.2,2.7,3.5
03360026,Weste,03,Niedersachsen,1006,488,518,99,60,39,34,21,13,9.8,6.0,3.9,3.4,2.1,1.3
03360029,Wriedel,03,Niedersachsen,2414,1207,1207,197,137,60,125,82,43,8.2,5.7,2.5,5.2,3.4,1.8
03360005,"Bad Bodenteich, Flecken",03,Niedersachsen,3761,1833,1928,255,182,73,218,163,55,6.8,4.8,1.9,5.8,4.3,1.5
03360013,Lüder,03,Niedersachsen,1241,622,619,92,64,28,57,37,20,7.4,5.2,2.3,4.6,3.0,1.6
03360020,Soltendieck,03,Niedersachsen,1020,512,508,77,51,26,26,14,12,7.5,5.0,2.5,2.5,1.4,1.2
03360030,Wrestedt,03,Niedersachsen,6541,3241,3300,566,409,157,374,284,90,8.7,6.3,2.4,5.7,4.3,1.4
03361001,"Achim, Stadt",03,Niedersachsen,31156,15142,16014,2987,1925,1062,2879,1795,1084,9.6,6.2,3.4,9.2,5.8,3.5
03361003,Dörverden,03,Niedersachsen,8993,4485,4508,887,583,304,508,328,180,9.9,6.5,3.4,5.6,3.6,2.0
03361005,Kirchlinteln,03,Niedersachsen,10132,5149,4983,1019,647,372,595,375,220,10.1,6.4,3.7,5.9,3.7,2.2
03361006,"Langwedel, Flecken",03,Niedersachsen,14414,7099,7315,1366,902,464,878,573,305,9.5,6.3,3.2,6.1,4.0,2.1
03361008,"Ottersberg, Flecken",03,Niedersachsen,12443,6083,6360,1304,898,406,1513,1107,406,10.5,7.2,3.3,12.2,8.9,3.3
03361009,Oyten,03,Niedersachsen,15604,7654,7950,1541,988,553,1401,945,456,9.9,6.3,3.5,9.0,6.1,2.9
03361012,"Verden (Aller), Stadt",03,Niedersachsen,26997,12975,14022,2750,1765,985,3225,2170,1055,10.2,6.5,3.6,11.9,8.0,3.9
03361002,Blender,03,Niedersachsen,2856,1465,1391,283,178,105,172,105,67,9.9,6.2,3.7,6.0,3.7,2.3
03361004,Emtinghausen,03,Niedersachsen,1504,763,741,179,110,69,139,82,57,11.9,7.3,4.6,9.2,5.5,3.8
03361010,Riede,03,Niedersachsen,2742,1376,1366,254,149,105,182,113,69,9.3,5.4,3.8,6.6,4.1,2.5
03361013,Thedinghausen,03,Niedersachsen,7804,3949,3855,819,513,306,553,362,191,10.5,6.6,3.9,7.1,4.6,2.4
03401000,"Delmenhorst, Stadt",03,Niedersachsen,76323,37823,38500,7147,4814,2333,9383,6657,2726,9.4,6.3,3.1,12.3,8.7,3.6
03402000,"Emden, Stadt",03,Niedersachsen,50694,25249,25445,5294,3957,1337,7056,5141,1915,10.4,7.8,2.6,13.9,10.1,3.8
03403000,"Oldenburg (Oldenburg), Stadt",03,Niedersachsen,163830,78259,85571,16102,10958,5144,19607,13567,6040,9.8,6.7,3.1,12.0,8.3,3.7
03404000,"Osnabrück, Stadt",03,Niedersachsen,162403,78275,84128,18305,12658,5647,25275,17014,8261,11.3,7.8,3.5,15.6,10.5,5.1
03405000,"Wilhelmshaven, Stadt",03,Niedersachsen,75995,37244,38751,7306,5264,2042,7505,5387,2118,9.6,6.9,2.7,9.9,7.1,2.8
03451001,Apen,03,Niedersachsen,11334,5653,5681,1317,918,399,1248,860,388,11.6,8.1,3.5,11.0,7.6,3.4
03451002,Bad Zwischenahn,03,Niedersachsen,28204,13539,14665,2882,1932,950,2933,2006,927,10.2,6.9,3.4,10.4,7.1,3.3
03451004,Edewecht,03,Niedersachsen,21827,10757,11070,2365,1564,801,1648,1059,589,10.8,7.2,3.7,7.6,4.9,2.7
03451005,Rastede,03,Niedersachsen,22027,10849,11178,2138,1412,726,1805,1223,582,9.7,6.4,3.3,8.2,5.6,2.6
03451007,"Westerstede, Stadt",03,Niedersachsen,22154,10854,11300,2490,1588,902,2459,1557,902,11.2,7.2,4.1,11.1,7.0,4.1
03451008,Wiefelstede,03,Niedersachsen,15889,7935,7954,1744,1107,637,1481,963,518,11.0,7.0,4.0,9.3,6.1,3.3
03452001,"Aurich, Stadt",03,Niedersachsen,41489,20358,21131,4053,2950,1103,4510,3367,1143,9.8,7.1,2.7,10.9,8.1,2.8
03452002,Baltrum,03,Niedersachsen,610,284,326,53,-1,-1,67,41,26,8.7,,,11.0,6.7,4.3
03452006,Großefehn,03,Niedersachsen,13837,7006,6831,1365,1055,310,1170,892,278,9.9,7.6,2.2,8.5,6.4,2.0
03452007,Großheide,03,Niedersachsen,8551,4279,4272,857,680,177,433,352,81,10.0,8.0,2.1,5.1,4.1,0.9
03452011,Hinte,03,Niedersachsen,7008,3499,3509,714,569,145,289,222,67,10.2,8.1,2.1,4.1,3.2,1.0
03452012,Ihlow,03,Niedersachsen,12267,6128,6139,1297,959,338,984,746,238,10.6,7.8,2.8,8.0,6.1,1.9
03452013,Juist,03,Niedersachsen,1596,778,818,150,67,83,131,67,64,9.4,4.2,5.2,8.2,4.2,4.0
03452014,Krummhörn,03,Niedersachsen,12123,5997,6126,1333,1034,299,1104,877,227,11.0,8.5,2.5,9.1,7.2,1.9
03452019,"Norden, Stadt",03,Niedersachsen,25117,12163,12954,2392,1834,558,2855,2216,639,9.5,7.3,2.2,11.4,8.8,2.5
03452020,"Norderney, Stadt",03,Niedersachsen,5935,2815,3120,717,343,374,721,353,368,12.1,5.8,6.3,12.1,5.9,6.2
03452023,Südbrookmerland,03,Niedersachsen,18573,9260,9313,1980,1615,365,1388,1066,322,10.7,8.7,2.0,7.5,5.7,1.7
03452025,"Wiesmoor, Stadt",03,Niedersachsen,13005,6292,6713,1416,1098,318,1693,1363,330,10.9,8.4,2.4,13.0,10.5,2.5
03452027,Dornum,03,Niedersachsen,4636,2326,2310,407,314,93,394,307,87,8.8,6.8,2.0,8.5,6.6,1.9
03452015,Leezdorf,03,Niedersachsen,1886,928,958,192,149,43,81,65,16,10.2,7.9,2.3,4.3,3.4,0.8
03452017,"Marienhafe, Flecken",03,Niedersachsen,2336,1097,1239,212,167,45,307,254,53,9.1,7.1,1.9,13.1,10.9,2.3
03452021,Osteel,03,Niedersachsen,2211,1109,1102,210,165,45,62,45,17,9.5,7.5,2.0,2.8,2.0,0.8
03452022,Rechtsupweg,03,Niedersachsen,2017,1041,976,194,152,42,50,36,14,9.6,7.5,2.1,2.5,1.8,0.7
03452024,Upgant-Schott,03,Niedersachsen,3845,1926,1919,387,299,88,177,147,30,10.1,7.8,2.3,4.6,3.8,0.8
03452026,Wirdum,03,Niedersachsen,1057,521,536,110,85,25,41,32,9,10.4,8.0,2.4,3.9,3.0,0.9
03452003,Berumbur,03,Niedersachsen,2700,1337,1363,244,193,51,160,132,28,9.0,7.1,1.9,5.9,4.9,1.0
03452008,"Hage, Flecken",03,Niedersachsen,6221,2983,3238,522,410,112,411,322,89,8.4,6.6,1.8,6.6,5.2,1.4
03452009,Hagermarsch,03,Niedersachsen,431,225,206,21,-1,-1,-1,-1,-1,4.9,,,-0.2,,
03452010,Halbemond,03,Niedersachsen,995,498,497,108,83,25,-1,-1,-1,10.9,8.3,2.5,-0.1,,
03452016,Lütetsburg,03,Niedersachsen,753,362,391,80,53,27,82,50,32,10.6,7.0,3.6,10.9,6.6,4.2
03453001,Barßel,03,Niedersachsen,12714,6362,6352,1405,985,420,1027,738,289,11.1,7.7,3.3,8.1,5.8,2.3
03453002,Bösel,03,Niedersachsen,7725,3943,3782,956,613,343,805,528,277,12.4,7.9,4.4,10.4,6.8,3.6
03453003,Cappeln (Oldenburg),03,Niedersachsen,6821,3600,3221,800,538,262,452,318,134,11.7,7.9,3.8,6.6,4.7,2.0
03453004,"Cloppenburg, Stadt",03,Niedersachsen,33798,16601,17197,3802,2594,1208,4660,3287,1373,11.2,7.7,3.6,13.8,9.7,4.1
03453005,Emstek,03,Niedersachsen,11855,6104,5751,1390,929,461,1211,796,415,11.7,7.8,3.9,10.2,6.7,3.5
03453006,Essen (Oldenburg),03,Niedersachsen,8676,4570,4106,965,628,337,720,482,238,11.1,7.2,3.9,8.3,5.6,2.7
03453007,"Friesoythe, Stadt",03,Niedersachsen,21918,11044,10874,2402,1693,709,2579,1805,774,11.0,7.7,3.2,11.8,8.2,3.5
03453008,Garrel,03,Niedersachsen,14634,7425,7209,1751,1163,588,1829,1146,683,12.0,7.9,4.0,12.5,7.8,4.7
03453009,Lastrup,03,Niedersachsen,6902,3540,3362,785,523,262,639,400,239,11.4,7.6,3.8,9.3,5.8,3.5
03453010,Lindern (Oldenburg),03,Niedersachsen,4709,2385,2324,537,386,151,476,339,137,11.4,8.2,3.2,10.1,7.2,2.9
03453011,"Löningen, Stadt",03,Niedersachsen,13270,6704,6566,1500,1041,459,1324,936,388,11.3,7.8,3.5,10.0,7.1,2.9
03453012,Molbergen,03,Niedersachsen,8429,4303,4126,871,607,264,790,526,264,10.3,7.2,3.1,9.4,6.2,3.1
03453013,Saterland,03,Niedersachsen,13283,6693,6590,1452,1023,429,1183,822,361,10.9,7.7,3.2,8.9,6.2,2.7
03454010,Emsbüren,03,Niedersachsen,9939,5023,4916,1297,930,367,1233,877,356,13.0,9.4,3.7,12.4,8.8,3.6
03454014,Geeste,03,Niedersachsen,11231,5779,5452,1337,942,395,943,654,289,11.9,8.4,3.5,8.4,5.8,2.6
03454018,"Haren (Ems), Stadt",03,Niedersachsen,23545,11898,11647,2955,2148,807,2658,1960,698,12.6,9.1,3.4,11.3,8.3,3.0
03454019,"Haselünne, Stadt",03,Niedersachsen,12656,6319,6337,1680,1190,490,1582,1152,430,13.3,9.4,3.9,12.5,9.1,3.4
03454032,"Lingen (Ems), Stadt",03,Niedersachsen,53284,26345,26939,6373,4493,1880,6614,4667,1947,12.0,8.4,3.5,12.4,8.8,3.7
03454035,"Meppen, Stadt",03,Niedersachsen,34918,17249,17669,3941,2697,1244,4929,3386,1543,11.3,7.7,3.6,14.1,9.7,4.4
03454041,"Papenburg, Stadt",03,Niedersachsen,36690,18750,17940,3794,2900,894,4838,3680,1158,10.3,7.9,2.4,13.2,10.0,3.2
03454044,Rhede (Ems),03,Niedersachsen,4174,2178,1996,501,396,105,643,506,137,12.0,9.5,2.5,15.4,12.1,3.3
03454045,Salzbergen,03,Niedersachsen,7570,3832,3738,1018,733,285,956,712,244,13.4,9.7,3.8,12.6,9.4,3.2
03454054,Twist,03,Niedersachsen,9676,5040,4636,1176,842,334,886,627,259,12.2,8.7,3.5,9.2,6.5,2.7
03454007,Dersum,03,Niedersachsen,1476,760,716,223,137,86,177,96,81,15.1,9.3,5.8,12.0,6.5,5.5
03454008,Dörpen,03,Niedersachsen,5025,2514,2511,666,466,200,860,616,244,13.3,9.3,4.0,17.1,12.3,4.9
03454020,Heede,03,Niedersachsen,2441,1272,1169,307,193,114,253,150,103,12.6,7.9,4.7,10.4,6.1,4.2
03454025,Kluse,03,Niedersachsen,1628,877,751,164,115,49,177,120,57,10.1,7.1,3.0,10.9,7.4,3.5
03454030,Lehe,03,Niedersachsen,1012,533,479,137,103,34,65,50,15,13.5,10.2,3.4,6.4,4.9,1.5
03454037,Neubörger,03,Niedersachsen,1544,775,769,158,117,41,103,72,31,10.2,7.6,2.7,6.7,4.7,2.0
03454038,Neulehe,03,Niedersachsen,774,404,370,110,79,31,108,58,50,14.2,10.2,4.0,14.0,7.5,6.5
03454056,Walchum,03,Niedersachsen,1511,771,740,183,121,62,129,80,49,12.1,8.0,4.1,8.5,5.3,3.2
03454060,Wippingen,03,Niedersachsen,944,494,450,114,82,32,81,58,23,12.1,8.7,3.4,8.6,6.1,2.4
03454001,Andervenne,03,Niedersachsen,882,456,426,111,72,39,81,39,42,12.6,8.2,4.4,9.2,4.4,4.8
03454003,Beesten,03,Niedersachsen,1584,838,746,211,132,79,238,145,93,13.3,8.3,5.0,15.0,9.2,5.9
03454012,"Freren, Stadt",03,Niedersachsen,5002,2526,2476,653,445,208,487,337,150,13.1,8.9,4.2,9.7,6.7,3.0
03454036,Messingen,03,Niedersachsen,1075,561,514,131,82,49,85,52,33,12.2,7.6,4.6,7.9,4.8,3.1
03454053,Thuine,03,Niedersachsen,1767,810,957,189,129,60,162,122,40,10.7,7.3,3.4,9.2,6.9,2.3
03454009,Dohren,03,Niedersachsen,1113,579,534,124,83,41,54,39,15,11.1,7.5,3.7,4.9,3.5,1.3
03454021,Herzlake,03,Niedersachsen,4371,2332,2039,568,382,186,761,561,200,13.0,8.7,4.3,17.4,12.8,4.6
03454026,Lähden,03,Niedersachsen,4797,2586,2211,540,386,154,458,279,179,11.3,8.0,3.2,9.5,5.8,3.7
03454013,Fresenburg,03,Niedersachsen,912,467,445,78,52,26,63,46,17,8.6,5.7,2.9,6.9,5.0,1.9
03454029,Lathen,03,Niedersachsen,6235,3141,3094,686,522,164,613,488,125,11.0,8.4,2.6,9.8,7.8,2.0
03454039,Niederlangen,03,Niedersachsen,1215,613,602,141,105,36,161,115,46,11.6,8.6,3.0,13.3,9.5,3.8
03454040,Oberlangen,03,Niedersachsen,938,487,451,117,83,34,47,38,9,12.5,8.8,3.6,5.0,4.1,1.0
03454043,Renkenberge,03,Niedersachsen,732,390,342,85,63,22,-1,-1,-1,11.6,8.6,3.0,-0.1,,
03454052,Sustrum,03,Niedersachsen,1291,683,608,136,100,36,109,79,30,10.5,7.7,2.8,8.4,6.1,2.3
03454002,Bawinkel,03,Niedersachsen,2407,1204,1203,286,220,66,291,224,67,11.9,9.1,2.7,12.1,9.3,2.8
03454015,Gersten,03,Niedersachsen,1224,634,590,146,98,48,151,96,55,11.9,8.0,3.9,12.3,7.8,4.5
03454017,Handrup,03,Niedersachsen,836,442,394,130,87,43,94,58,36,15.6,10.4,5.1,11.2,6.9,4.3
03454028,Langen,03,Niedersachsen,1428,715,713,201,151,50,118,86,32,14.1,10.6,3.5,8.3,6.0,2.2
03454031,Lengerich,03,Niedersachsen,2662,1374,1288,332,219,113,291,203,88,12.5,8.2,4.2,10.9,7.6,3.3
03454059,Wettrup,03,Niedersachsen,568,300,268,88,68,20,-1,-1,-1,15.5,12.0,3.5,-0.2,,
03454004,Bockhorst,03,Niedersachsen,981,516,465,117,88,29,75,61,14,11.9,9.0,3.0,7.6,6.2,1.4
03454006,Breddenberg,03,Niedersachsen,802,412,390,76,56,20,36,21,15,9.5,7.0,2.5,4.5,2.6,1.9
03454011,Esterwegen,03,Niedersachsen,5280,2733,2547,612,466,146,426,346,80,11.6,8.8,2.8,8.1,6.6,1.5
03454022,Hilkenbrook,03,Niedersachsen,792,416,376,78,52,26,38,30,8,9.8,6.6,3.3,4.8,3.8,1.0
03454051,Surwold,03,Niedersachsen,4245,2197,2048,475,358,117,363,283,80,11.2,8.4,2.8,8.6,6.7,1.9
03454005,Börger,03,Niedersachsen,2749,1403,1346,250,190,60,230,170,60,9.1,6.9,2.2,8.4,6.2,2.2
03454016,Groß Berßen,03,Niedersachsen,665,346,319,80,58,22,82,71,11,12.0,8.7,3.3,12.3,10.7,1.7
03454023,Hüven,03,Niedersachsen,525,287,238,79,51,28,54,37,17,15.0,9.7,5.3,10.3,7.0,3.2
03454024,Klein Berßen,03,Niedersachsen,1102,581,521,162,125,37,216,165,51,14.7,11.3,3.4,19.6,15.0,4.6
03454047,Sögel,03,Niedersachsen,7464,3994,3470,771,564,207,816,569,247,10.3,7.6,2.8,10.9,7.6,3.3
03454048,Spahnharrenstätte,03,Niedersachsen,1512,782,730,166,113,53,139,97,42,11.0,7.5,3.5,9.2,6.4,2.8
03454050,Stavern,03,Niedersachsen,1045,540,505,127,85,42,69,46,23,12.2,8.1,4.0,6.6,4.4,2.2
03454058,Werpeloh,03,Niedersachsen,1082,568,514,120,86,34,84,62,22,11.1,7.9,3.1,7.8,5.7,2.0
03454034,Lünne,03,Niedersachsen,1875,979,896,246,179,67,238,165,73,13.1,9.5,3.6,12.7,8.8,3.9
03454046,Schapen,03,Niedersachsen,2332,1204,1128,354,242,112,323,214,109,15.2,10.4,4.8,13.9,9.2,4.7
03454049,Spelle,03,Niedersachsen,8971,4590,4381,1258,870,388,997,697,300,14.0,9.7,4.3,11.1,7.8,3.3
03454027,Lahn,03,Niedersachsen,906,494,412,88,68,20,68,51,17,9.7,7.5,2.2,7.5,5.6,1.9
03454033,Lorup,03,Niedersachsen,3172,1722,1450,343,256,87,403,310,93,10.8,8.1,2.7,12.7,9.8,2.9
03454042,Rastdorf,03,Niedersachsen,1067,574,493,103,75,28,66,40,26,9.7,7.0,2.6,6.2,3.7,2.4
03454055,Vrees,03,Niedersachsen,1767,983,784,196,147,49,200,134,66,11.1,8.3,2.8,11.3,7.6,3.7
03454057,Werlte,03,Niedersachsen,10077,5210,4867,1262,893,369,1239,912,327,12.5,8.9,3.7,12.3,9.1,3.2
03455007,"Jever, Stadt",03,Niedersachsen,14020,6695,7325,1432,1032,400,1499,1129,370,10.2,7.4,2.9,10.7,8.1,2.6
03455014,Sande,03,Niedersachsen,8879,4352,4527,783,559,224,601,417,184,8.8,6.3,2.5,6.8,4.7,2.1
03455015,"Schortens, Stadt",03,Niedersachsen,20321,9911,10410,1894,1380,514,1256,889,367,9.3,6.8,2.5,6.2,4.4,1.8
03455020,Wangerland,03,Niedersachsen,9213,4517,4696,1106,795,311,1098,758,340,12.0,8.6,3.4,11.9,8.2,3.7
03455021,"Wangerooge, Nordseebad",03,Niedersachsen,1304,629,675,177,83,94,189,88,101,13.6,6.4,7.2,14.5,6.7,7.7
03455025,Bockhorn,03,Niedersachsen,8594,4295,4299,857,591,266,683,511,172,10.0,6.9,3.1,7.9,5.9,2.0
03455026,"Varel, Stadt",03,Niedersachsen,23884,11598,12286,2401,1691,710,2429,1717,712,10.1,7.1,3.0,10.2,7.2,3.0
03455027,Zetel,03,Niedersachsen,11685,5774,5911,1138,823,315,831,594,237,9.7,7.0,2.7,7.1,5.1,2.0
03456001,"Bad Bentheim, Stadt",03,Niedersachsen,15311,7559,7752,1817,1280,537,1928,1364,564,11.9,8.4,3.5,12.6,8.9,3.7
03456015,"Nordhorn, Stadt",03,Niedersachsen,53285,26269,27016,6786,4579,2207,8280,5616,2664,12.7,8.6,4.1,15.5,10.5,5.0
03456025,Wietmarschen,03,Niedersachsen,11863,5983,5880,1588,1107,481,1255,869,386,13.4,9.3,4.1,10.6,7.3,3.3
03456002,Emlichheim,03,Niedersachsen,7393,3722,3671,986,690,296,1139,862,277,13.3,9.3,4.0,15.4,11.7,3.7
03456009,Hoogstede,03,Niedersachsen,2881,1454,1427,446,286,160,420,234,186,15.5,9.9,5.6,14.6,8.1,6.5
03456012,Laar,03,Niedersachsen,2168,1101,1067,262,197,65,138,91,47,12.1,9.1,3.0,6.4,4.2,2.2
03456019,Ringe,03,Niedersachsen,2083,1097,986,257,181,76,160,113,47,12.3,8.7,3.6,7.7,5.4,2.3
03456004,Esche,03,Niedersachsen,556,288,268,94,67,27,38,27,11,16.9,12.1,4.9,6.8,4.9,2.0
03456005,Georgsdorf,03,Niedersachsen,1251,633,618,189,135,54,100,69,31,15.1,10.8,4.3,8.0,5.5,2.5
03456013,Lage,03,Niedersachsen,1064,555,509,138,100,38,39,29,10,13.0,9.4,3.6,3.7,2.7,0.9
03456014,"Neuenhaus, Stadt",03,Niedersachsen,9894,4962,4932,1262,881,381,1122,784,338,12.8,8.9,3.9,11.3,7.9,3.4
03456017,Osterwald,03,Niedersachsen,1172,604,568,163,113,50,186,128,58,13.9,9.6,4.3,15.9,10.9,4.9
03456003,Engden,03,Niedersachsen,431,216,215,71,55,16,57,41,16,16.5,12.8,3.7,13.2,9.5,3.7
03456010,Isterberg,03,Niedersachsen,566,286,280,77,49,28,56,27,29,13.6,8.7,4.9,9.9,4.8,5.1
03456016,Ohne,03,Niedersachsen,587,299,288,80,47,33,75,39,36,13.6,8.0,5.6,12.8,6.6,6.1
03456018,Quendorf,03,Niedersachsen,543,265,278,61,39,22,35,27,8,11.2,7.2,4.1,6.4,5.0,1.5
03456020,Samern,03,Niedersachsen,728,380,348,91,51,40,126,71,55,12.5,7.0,5.5,17.3,9.8,7.6
03456027,"Schüttorf, Stadt",03,Niedersachsen,12627,6360,6267,1879,1243,636,1649,1018,631,14.9,9.8,5.0,13.1,8.1,5.0
03456006,Getelo,03,Niedersachsen,564,315,249,61,45,16,14,11,3,10.8,8.0,2.8,2.5,2.0,0.5
03456007,Gölenkamp,03,Niedersachsen,592,302,290,92,64,28,44,23,21,15.5,10.8,4.7,7.4,3.9,3.5
03456008,Halle,03,Niedersachsen,648,330,318,74,56,18,100,69,31,11.4,8.6,2.8,15.4,10.6,4.8
03456011,Itterbeck,03,Niedersachsen,1747,895,852,251,173,78,210,125,85,14.4,9.9,4.5,12.0,7.2,4.9
03456023,Uelsen,03,Niedersachsen,5558,2800,2758,860,610,250,890,636,254,15.5,11.0,4.5,16.0,11.4,4.6
03456024,Wielen,03,Niedersachsen,543,288,255,62,52,10,21,14,7,11.4,9.6,1.8,3.9,2.6,1.3
03456026,Wilsum,03,Niedersachsen,1607,817,790,244,160,84,241,178,63,15.2,10.0,5.2,15.0,11.1,3.9
03457002,"Borkum, Stadt",03,Niedersachsen,5473,2620,2853,630,276,354,574,264,310,11.5,5.0,6.5,10.5,4.8,5.7
03457012,Jemgum,03,Niedersachsen,3539,1788,1751,396,317,79,277,222,55,11.2,9.0,2.2,7.8,6.3,1.6
03457013,"Leer (Ostfriesland), Stadt",03,Niedersachsen,34042,16965,17077,3322,2497,825,8087,5979,2108,9.8,7.3,2.4,23.8,17.6,6.2
03457014,Moormerland,03,Niedersachsen,23138,11481,11657,2351,1866,485,1446,1175,271,10.2,8.1,2.1,6.2,5.1,1.2
03457017,Ostrhauderfehn,03,Niedersachsen,11032,5390,5642,1182,919,263,870,662,208,10.7,8.3,2.4,7.9,6.0,1.9
03457018,Rhauderfehn,03,Niedersachsen,17815,8879,8936,1710,1331,379,1295,1084,211,9.6,7.5,2.1,7.3,6.1,1.2
03457020,Uplengen,03,Niedersachsen,11678,5841,5837,1324,1016,308,1139,858,281,11.3,8.7,2.6,9.8,7.3,2.4
03457021,"Weener, Stadt",03,Niedersachsen,15510,7727,7783,1420,1171,249,1000,810,190,9.2,7.5,1.6,6.4,5.2,1.2
03457022,Westoverledingen,03,Niedersachsen,20482,10321,10161,2194,1736,458,1101,886,215,10.7,8.5,2.2,5.4,4.3,1.0
03457024,Bunde,03,Niedersachsen,7607,3817,3790,693,551,142,479,392,87,9.1,7.2,1.9,6.3,5.2,1.1
03457003,Brinkum,03,Niedersachsen,711,382,329,80,63,17,-1,-1,-1,11.3,8.9,2.4,-0.1,,
03457009,Firrel,03,Niedersachsen,816,416,400,83,62,21,85,55,30,10.2,7.6,2.6,10.4,6.7,3.7
03457010,Hesel,03,Niedersachsen,4600,2317,2283,479,376,103,390,302,88,10.4,8.2,2.2,8.5,6.6,1.9
03457011,Holtland,03,Niedersachsen,2238,1083,1155,235,181,54,127,107,20,10.5,8.1,2.4,5.7,4.8,0.9
03457015,Neukamperfehn,03,Niedersachsen,1647,805,842,156,126,30,48,38,10,9.5,7.7,1.8,2.9,2.3,0.6
03457019,Schwerinsdorf,03,Niedersachsen,694,335,359,65,53,12,-1,-1,-1,9.4,7.6,1.7,-0.1,,
03457006,"Detern, Flecken",03,Niedersachsen,2735,1364,1371,257,194,63,147,117,30,9.4,7.1,2.3,5.4,4.3,1.1
03457008,Filsum,03,Niedersachsen,2089,1024,1065,224,172,52,166,137,29,10.7,8.2,2.5,7.9,6.6,1.4
03457016,Nortmoor,03,Niedersachsen,1702,876,826,202,163,39,202,143,59,11.9,9.6,2.3,11.9,8.4,3.5
03458003,Dötlingen,03,Niedersachsen,6212,3130,3082,720,434,286,780,421,359,11.6,7.0,4.6,12.6,6.8,5.8
03458005,Ganderkesee,03,Niedersachsen,30943,15298,15645,3020,2000,1020,2784,1792,992,9.8,6.5,3.3,9.0,5.8,3.2
03458007,Großenkneten,03,Niedersachsen,15208,7866,7342,1348,890,458,1105,734,371,8.9,5.9,3.0,7.3,4.8,2.4
03458009,Hatten,03,Niedersachsen,13986,6896,7090,1372,884,488,1109,700,409,9.8,6.3,3.5,7.9,5.0,2.9
03458010,Hude (Oldb),03,Niedersachsen,16166,8075,8091,1567,1022,545,1215,770,445,9.7,6.3,3.4,7.5,4.8,2.8
03458013,Wardenburg,03,Niedersachsen,15804,7706,8098,1610,1047,563,1413,902,511,10.2,6.6,3.6,8.9,5.7,3.2
03458014,"Wildeshausen, Stadt",03,Niedersachsen,19390,9565,9825,1995,1220,775,1941,1255,686,10.3,6.3,4.0,10.0,6.5,3.5
03458001,Beckeln,03,Niedersachsen,789,406,383,99,61,38,56,31,25,12.5,7.7,4.8,7.1,3.9,3.2
03458002,Colnrade,03,Niedersachsen,785,420,365,95,54,41,61,36,25,12.1,6.9,5.2,7.8,4.6,3.2
03458004,Dünsen,03,Niedersachsen,1187,599,588,133,77,56,39,25,14,11.2,6.5,4.7,3.3,2.1,1.2
03458006,Groß Ippener,03,Niedersachsen,1016,517,499,102,67,35,180,108,72,10.0,6.6,3.4,17.7,10.6,7.1
03458008,"Harpstedt, Flecken",03,Niedersachsen,4682,2247,2435,469,314,155,421,282,139,10.0,6.7,3.3,9.0,6.0,3.0
03458011,Kirchseelte,03,Niedersachsen,1176,607,569,121,83,38,90,60,30,10.3,7.1,3.2,7.7,5.1,2.6
03458012,Prinzhöfte,03,Niedersachsen,691,350,341,60,40,20,93,61,32,8.7,5.8,2.9,13.5,8.8,4.6
03458015,Winkelsett,03,Niedersachsen,573,306,267,68,41,27,63,38,25,11.9,7.2,4.7,11.0,6.6,4.4
03459003,Bad Essen,03,Niedersachsen,15263,7544,7719,1648,1081,567,1500,1000,500,10.8,7.1,3.7,9.8,6.6,3.3
03459004,"Bad Iburg, Stadt",03,Niedersachsen,10548,5060,5488,1375,912,463,1209,820,389,13.0,8.6,4.4,11.5,7.8,3.7
03459005,Bad Laer,03,Niedersachsen,9268,4576,4692,1197,735,462,1482,893,589,12.9,7.9,5.0,16.0,9.6,6.4
03459006,Bad Rothenfelde,03,Niedersachsen,7839,3763,4076,872,519,353,1103,669,434,11.1,6.6,4.5,14.1,8.5,5.5
03459008,Belm,03,Niedersachsen,13581,6634,6947,1488,973,515,840,559,281,11.0,7.2,3.8,6.2,4.1,2.1
03459012,Bissendorf,03,Niedersachsen,14370,7107,7263,1541,983,558,1261,823,438,10.7,6.8,3.9,8.8,5.7,3.0
03459013,Bohmte,03,Niedersachsen,12637,6281,6356,1460,929,531,1003,649,354,11.6,7.4,4.2,7.9,5.1,2.8
03459014,"Bramsche, Stadt",03,Niedersachsen,36013,19095,16918,3476,2405,1071,3896,2576,1320,9.7,6.7,3.0,10.8,7.2,3.7
03459015,"Dissen am Teutoburger Wald, Stadt",03,Niedersachsen,9390,4703,4687,1164,643,521,1061,625,436,12.4,6.8,5.5,11.3,6.7,4.6
03459019,"Georgsmarienhütte, Stadt",03,Niedersachsen,31520,15422,16098,3793,2482,1311,3522,2311,1211,12.0,7.9,4.2,11.2,7.3,3.8
03459020,Hagen am Teutoburger Wald,03,Niedersachsen,13475,6613,6862,1559,1037,522,1198,792,406,11.6,7.7,3.9,8.9,5.9,3.0
03459021,Hasbergen,03,Niedersachsen,10901,5324,5577,1205,795,410,972,624,348,11.1,7.3,3.8,8.9,5.7,3.2
03459022,Hilter am Teutoburger Wald,03,Niedersachsen,10243,5064,5179,1182,738,444,900,553,347,11.5,7.2,4.3,8.8,5.4,3.4
03459024,"Melle, Stadt",03,Niedersachsen,46039,22786,23253,5114,3316,1798,4585,2951,1634,11.1,7.2,3.9,10.0,6.4,3.5
03459029,Ostercappeln,03,Niedersachsen,9566,4719,4847,1082,700,382,869,558,311,11.3,7.3,4.0,9.1,5.8,3.3
03459033,Wallenhorst,03,Niedersachsen,23018,11282,11736,2754,1779,975,2596,1697,899,12.0,7.7,4.2,11.3,7.4,3.9
03459034,Glandorf,03,Niedersachsen,6664,3413,3251,918,588,330,799,501,298,13.8,8.8,5.0,12.0,7.5,4.5
03459007,Badbergen,03,Niedersachsen,4572,2440,2132,464,286,178,306,152,154,10.1,6.3,3.9,6.7,3.3,3.4
03459025,Menslage,03,Niedersachsen,2462,1283,1179,234,168,66,130,90,40,9.5,6.8,2.7,5.3,3.7,1.6
03459028,Nortrup,03,Niedersachsen,2960,1480,1480,364,254,110,290,182,108,12.3,8.6,3.7,9.8,6.1,3.6
03459030,"Quakenbrück, Stadt",03,Niedersachsen,12845,6309,6536,1372,901,471,1513,1051,462,10.7,7.0,3.7,11.8,8.2,3.6
03459001,Alfhausen,03,Niedersachsen,3910,1983,1927,475,313,162,622,421,201,12.1,8.0,4.1,15.9,10.8,5.1
03459002,Ankum,03,Niedersachsen,7314,3640,3674,890,582,308,889,611,278,12.2,8.0,4.2,12.2,8.4,3.8
03459010,"Bersenbrück, Stadt",03,Niedersachsen,8315,4122,4193,981,650,331,1067,736,331,11.8,7.8,4.0,12.8,8.9,4.0
03459016,Eggermühlen,03,Niedersachsen,1703,852,851,245,157,88,126,84,42,14.4,9.2,5.2,7.4,4.9,2.5
03459018,Gehrde,03,Niedersachsen,2504,1269,1235,285,202,83,170,112,58,11.4,8.1,3.3,6.8,4.5,2.3
03459023,Kettenkamp,03,Niedersachsen,1688,889,799,223,145,78,332,150,182,13.2,8.6,4.6,19.7,8.9,10.8
03459031,Rieste,03,Niedersachsen,3436,1753,1683,434,273,161,372,250,122,12.6,7.9,4.7,10.8,7.3,3.6
03459009,Berge,03,Niedersachsen,3518,1769,1749,345,250,95,268,203,65,9.8,7.1,2.7,7.6,5.8,1.8
03459011,Bippen,03,Niedersachsen,2945,1477,1468,300,209,91,186,139,47,10.2,7.1,3.1,6.3,4.7,1.6
03459017,"Fürstenau, Stadt",03,Niedersachsen,9410,4628,4782,1079,775,304,962,685,277,11.5,8.2,3.2,10.2,7.3,2.9
03459026,Merzen,03,Niedersachsen,3921,2022,1899,450,304,146,377,225,152,11.5,7.8,3.7,9.6,5.7,3.9
03459027,Neuenkirchen,03,Niedersachsen,4498,2258,2240,568,381,187,570,376,194,12.6,8.5,4.2,12.7,8.4,4.3
03459032,Voltlage,03,Niedersachsen,1743,915,828,249,151,98,167,115,52,14.3,8.7,5.6,9.6,6.6,3.0
03460001,Bakum,03,Niedersachsen,6123,3120,3003,808,496,312,729,426,303,13.2,8.1,5.1,11.9,7.0,4.9
03460002,"Damme, Stadt",03,Niedersachsen,16872,8464,8408,2062,1276,786,2089,1314,775,12.2,7.6,4.7,12.4,7.8,4.6
03460003,"Dinklage, Stadt",03,Niedersachsen,12914,6533,6381,1638,968,670,1484,947,537,12.7,7.5,5.2,11.5,7.3,4.2
03460004,Goldenstedt,03,Niedersachsen,9572,4846,4726,1421,855,566,1010,571,439,14.8,8.9,5.9,10.6,6.0,4.6
03460005,Holdorf,03,Niedersachsen,6816,3489,3327,865,521,344,1016,615,401,12.7,7.6,5.0,14.9,9.0,5.9
03460006,"Lohne (Oldenburg), Stadt",03,Niedersachsen,26060,13210,12850,3339,2037,1302,3766,2368,1398,12.8,7.8,5.0,14.5,9.1,5.4
03460007,Neuenkirchen-Vörden,03,Niedersachsen,8392,4261,4131,1005,626,379,906,598,308,12.0,7.5,4.5,10.8,7.1,3.7
03460008,Steinfeld (Oldenburg),03,Niedersachsen,9903,5101,4802,1290,760,530,1127,650,477,13.0,7.7,5.4,11.4,6.6,4.8
03460009,"Vechta, Stadt",03,Niedersachsen,31558,15536,16022,4503,2970,1533,5666,3610,2056,14.3,9.4,4.9,18.0,11.4,6.5
03460010,Visbek,03,Niedersachsen,9656,4975,4681,1319,856,463,1225,799,426,13.7,8.9,4.8,12.7,8.3,4.4
03461001,Berne,03,Niedersachsen,6896,3518,3378,664,420,244,365,223,142,9.6,6.1,3.5,5.3,3.2,2.1
03461002,"Brake (Unterweser), Stadt",03,Niedersachsen,15129,7394,7735,1524,1089,435,1561,1150,411,10.1,7.2,2.9,10.3,7.6,2.7
03461003,Butjadingen,03,Niedersachsen,6180,3039,3141,678,473,205,672,473,199,11.0,7.7,3.3,10.9,7.7,3.2
03461004,"Elsfleth, Stadt",03,Niedersachsen,9094,4654,4440,977,695,282,733,500,233,10.7,7.6,3.1,8.1,5.5,2.6
03461005,Jade,03,Niedersachsen,5823,2937,2886,598,394,204,356,244,112,10.3,6.8,3.5,6.1,4.2,1.9
03461006,Lemwerder,03,Niedersachsen,6940,3568,3372,629,434,195,424,311,113,9.1,6.3,2.8,6.1,4.5,1.6
03461007,"Nordenham, Stadt",03,Niedersachsen,26325,13098,13227,2484,1771,713,2040,1427,613,9.4,6.7,2.7,7.7,5.4,2.3
03461008,Ovelgönne,03,Niedersachsen,5376,2681,2695,544,359,185,393,267,126,10.1,6.7,3.4,7.3,5.0,2.3
03461009,Stadland,03,Niedersachsen,7476,3760,3716,782,552,230,857,541,316,10.5,7.4,3.1,11.5,7.2,4.2
03462005,Friedeburg,03,Niedersachsen,10251,5082,5169,986,704,282,738,523,215,9.6,6.9,2.8,7.2,5.1,2.1
03462007,Langeoog,03,Niedersachsen,1790,845,945,218,112,106,294,165,129,12.2,6.3,5.9,16.4,9.2,7.2
03462014,Spiekeroog,03,Niedersachsen,768,366,402,99,32,67,101,41,60,12.9,4.2,8.7,13.2,5.3,7.8
03462019,"Wittmund, Stadt",03,Niedersachsen,20735,10253,10482,2070,1515,555,2104,1512,592,10.0,7.3,2.7,10.1,7.3,2.9
03462002,Dunum,03,Niedersachsen,1131,557,574,103,76,27,19,8,11,9.1,6.7,2.4,1.7,0.7,1.0
03462003,"Esens, Stadt",03,Niedersachsen,7284,3412,3872,762,543,219,990,756,234,10.5,7.5,3.0,13.6,10.4,3.2
03462006,Holtgast,03,Niedersachsen,1707,842,865,164,126,38,59,45,14,9.6,7.4,2.2,3.5,2.6,0.8
03462008,Moorweg,03,Niedersachsen,859,423,436,86,56,30,20,10,10,10.0,6.5,3.5,2.3,1.2,1.2
03462010,Neuharlingersiel,03,Niedersachsen,1000,496,504,104,73,31,256,181,75,10.4,7.3,3.1,25.6,18.1,7.5
03462015,Stedesdorf,03,Niedersachsen,1542,782,760,139,104,35,42,24,18,9.0,6.7,2.3,2.7,1.6,1.2
03462017,Werdum,03,Niedersachsen,741,368,373,92,66,26,113,77,36,12.4,8.9,3.5,15.2,10.4,4.9
03462001,Blomberg,03,Niedersachsen,1760,878,882,211,153,58,120,85,35,12.0,8.7,3.3,6.8,4.8,2.0
03462004,Eversmeer,03,Niedersachsen,844,437,407,84,61,23,-1,-1,-1,10.0,7.2,2.7,-0.1,,
03462009,Nenndorf,03,Niedersachsen,734,361,373,102,74,28,50,38,12,13.9,10.1,3.8,6.8,5.2,1.6
03462011,Neuschoo,03,Niedersachsen,1199,607,592,132,93,39,35,16,19,11.0,7.8,3.3,2.9,1.3,1.6
03462012,Ochtersum,03,Niedersachsen,869,440,429,112,79,33,21,12,9,12.9,9.1,3.8,2.4,1.4,1.0
03462013,Schweindorf,03,Niedersachsen,760,356,404,63,46,17,46,35,11,8.3,6.1,2.2,6.1,4.6,1.4
03462016,Utarp,03,Niedersachsen,623,317,306,55,43,12,-1,-1,-1,8.8,6.9,1.9,-0.2,,
03462018,Westerholt,03,Niedersachsen,2576,1249,1327,237,176,61,274,174,100,9.2,6.8,2.4,10.6,6.8,3.9
