ags,name,bundesland_id,bundesland,bevoelkerung_total,bevoelkerung_maennlich,bevoelkerung_weiblich,mj_wohnort_insgesamt,mj_wohnort_ausschliesslich,mj_wohnort_nebenjob,mj_arbeitsort_insgesamt,mj_arbeitsort_ausschliesslich,mj_arbeitsort_nebenjob,mj_wohnort_insgesamt_prozent,mj_wohnort_ausschliesslich_prozent,mj_wohnort_nebenjob_prozent,mj_arbeitsort_insgesamt_prozent,mj_arbeitsort_ausschliesslich_prozent,mj_arbeitsort_nebenjob_prozent
05111000,"Düsseldorf, Stadt",05,Nordrhein-Westfalen,612178,295896,316282,54669,35525,19144,72031,47574,24457,8.9,5.8,3.1,11.8,7.8,4.0
05112000,"Duisburg, Stadt",05,Nordrhein-Westfalen,491231,241417,249814,41813,31151,10662,36694,27259,9435,8.5,6.3,2.2,7.5,5.5,1.9
05113000,"Essen, Stadt",05,Nordrhein-Westfalen,582624,282565,300059,50674,37211,13463,60185,44104,16081,8.7,6.4,2.3,10.3,7.6,2.8
05114000,"Krefeld, Stadt",05,Nordrhein-Westfalen,225144,109487,115657,21928,15373,6555,20602,14291,6311,9.7,6.8,2.9,9.2,6.3,2.8
05116000,"Mönchengladbach, Stadt",05,Nordrhein-Westfalen,259996,127512,132484,26669,18472,8197,28082,19638,8444,10.3,7.1,3.2,10.8,7.6,3.2
05117000,"Mülheim an der Ruhr, Stadt",05,Nordrhein-Westfalen,169278,81461,87817,14694,10465,4229,15589,11307,4282,8.7,6.2,2.5,9.2,6.7,2.5
05119000,"Oberhausen, Stadt",05,Nordrhein-Westfalen,210934,103284,107650,18889,14196,4693,20051,15028,5023,9.0,6.7,2.2,9.5,7.1,2.4
05120000,"Remscheid, Stadt",05,Nordrhein-Westfalen,109499,53725,55774,11448,7570,3878,11750,7852,3898,10.5,6.9,3.5,10.7,7.2,3.6
05122000,"Solingen, Klingenstadt",05,Nordrhein-Westfalen,158726,76948,81778,15546,10121,5425,13891,9044,4847,9.8,6.4,3.4,8.8,5.7,3.1
05124000,"Wuppertal, Stadt",05,Nordrhein-Westfalen,350046,170822,179224,33360,23110,10250,32897,22974,9923,9.5,6.6,2.9,9.4,6.6,2.8
05154004,Bedburg-Hau,05,Nordrhein-Westfalen,13033,6701,6332,1292,870,422,1001,700,301,9.9,6.7,3.2,7.7,5.4,2.3
05154008,"Emmerich am Rhein, Stadt",05,Nordrhein-Westfalen,30968,15705,15263,3011,2250,761,2999,2271,728,9.7,7.3,2.5,9.7,7.3,2.4
05154012,"Geldern, Stadt",05,Nordrhein-Westfalen,33841,17037,16804,3770,2648,1122,4960,3569,1391,11.1,7.8,3.3,14.7,10.5,4.1
05154016,"Goch, Stadt",05,Nordrhein-Westfalen,33889,16990,16899,3745,2626,1119,3422,2389,1033,11.1,7.7,3.3,10.1,7.0,3.0
05154020,Issum,05,Nordrhein-Westfalen,12037,5896,6141,1321,953,368,960,715,245,11.0,7.9,3.1,8.0,5.9,2.0
05154024,"Kalkar, Stadt",05,Nordrhein-Westfalen,13854,6884,6970,1775,1291,484,1793,1243,550,12.8,9.3,3.5,12.9,9.0,4.0
05154028,Kerken,05,Nordrhein-Westfalen,13262,6670,6592,1338,957,381,1069,774,295,10.1,7.2,2.9,8.1,5.8,2.2
05154032,"Kevelaer, Stadt",05,Nordrhein-Westfalen,28311,13925,14386,3334,2394,940,3183,2291,892,11.8,8.5,3.3,11.2,8.1,3.2
05154036,"Kleve, Stadt",05,Nordrhein-Westfalen,49729,24457,25272,5385,3849,1536,6561,4641,1920,10.8,7.7,3.1,13.2,9.3,3.9
05154040,Kranenburg,05,Nordrhein-Westfalen,10648,5444,5204,1061,740,321,923,594,329,10.0,6.9,3.0,8.7,5.6,3.1
05154044,"Rees, Stadt",05,Nordrhein-Westfalen,21349,10608,10741,2581,1895,686,1875,1390,485,12.1,8.9,3.2,8.8,6.5,2.3
05154048,Rheurdt,05,Nordrhein-Westfalen,6709,3327,3382,636,467,169,394,299,95,9.5,7.0,2.5,5.9,4.5,1.4
05154052,"Straelen, Stadt",05,Nordrhein-Westfalen,15641,7768,7873,1993,1341,652,2012,1351,661,12.7,8.6,4.2,12.9,8.6,4.2
05154056,Uedem,05,Nordrhein-Westfalen,8266,4111,4155,950,649,301,730,517,213,11.5,7.9,3.6,8.8,6.3,2.6
05154060,Wachtendonk,05,Nordrhein-Westfalen,8189,4115,4074,913,632,281,876,613,263,11.1,7.7,3.4,10.7,7.5,3.2
05154064,Weeze,05,Nordrhein-Westfalen,10611,5350,5261,1159,861,298,918,615,303,10.9,8.1,2.8,8.7,5.8,2.9
05158004,"Erkrath, Fundort des Neanderthalers, Stadt",05,Nordrhein-Westfalen,44086,21054,23032,4349,2959,1390,4252,2849,1403,9.9,6.7,3.2,9.6,6.5,3.2
05158008,"Haan, Stadt",05,Nordrhein-Westfalen,30410,14579,15831,2817,1910,907,2849,1829,1020,9.3,6.3,3.0,9.4,6.0,3.4
05158012,"Heiligenhaus, Stadt",05,Nordrhein-Westfalen,25793,12654,13139,2610,1677,933,2108,1394,714,10.1,6.5,3.6,8.2,5.4,2.8
05158016,"Hilden, Stadt",05,Nordrhein-Westfalen,55185,26620,28565,5435,3506,1929,5777,3774,2003,9.8,6.4,3.5,10.5,6.8,3.6
05158020,"Langenfeld (Rheinland), Stadt",05,Nordrhein-Westfalen,58033,28239,29794,5384,3567,1817,6525,4264,2261,9.3,6.1,3.1,11.2,7.3,3.9
05158024,"Mettmann, Stadt",05,Nordrhein-Westfalen,38291,18413,19878,3460,2376,1084,3124,2132,992,9.0,6.2,2.8,8.2,5.6,2.6
05158026,"Monheim am Rhein, Stadt",05,Nordrhein-Westfalen,40885,19650,21235,4026,2736,1290,2673,1805,868,9.8,6.7,3.2,6.5,4.4,2.1
05158028,"Ratingen, Stadt",05,Nordrhein-Westfalen,87943,42217,45726,8521,5644,2877,8656,5720,2936,9.7,6.4,3.3,9.8,6.5,3.3
05158032,"Velbert, Stadt",05,Nordrhein-Westfalen,81430,39660,41770,8202,5400,2802,8060,5420,2640,10.1,6.6,3.4,9.9,6.7,3.2
05158036,"Wülfrath, Stadt",05,Nordrhein-Westfalen,21223,10362,10861,2064,1399,665,1798,1248,550,9.7,6.6,3.1,8.5,5.9,2.6
05162004,"Dormagen, Stadt",05,Nordrhein-Westfalen,64064,31816,32248,5692,3926,1766,4487,3094,1393,8.9,6.1,2.8,7.0,4.8,2.2
05162008,"Grevenbroich, Stadt",05,Nordrhein-Westfalen,63051,30723,32328,6007,4147,1860,4941,3432,1509,9.5,6.6,2.9,7.8,5.4,2.4
05162012,Jüchen,05,Nordrhein-Westfalen,23260,11590,11670,2172,1519,653,2123,1455,668,9.3,6.5,2.8,9.1,6.3,2.9
05162016,"Kaarst, Stadt",05,Nordrhein-Westfalen,43286,20812,22474,3729,2531,1198,3180,2195,985,8.6,5.8,2.8,7.3,5.1,2.3
05162020,"Korschenbroich, Stadt",05,Nordrhein-Westfalen,32922,16085,16837,2953,2067,886,2709,1868,841,9.0,6.3,2.7,8.2,5.7,2.6
05162022,"Meerbusch, Stadt",05,Nordrhein-Westfalen,54892,26183,28709,4692,3199,1493,4570,3066,1504,8.5,5.8,2.7,8.3,5.6,2.7
05162024,"Neuss, Stadt",05,Nordrhein-Westfalen,155414,75929,79485,15158,10019,5139,14161,9535,4626,9.8,6.4,3.3,9.1,6.1,3.0
05162028,Rommerskirchen,05,Nordrhein-Westfalen,13137,6512,6625,1131,785,346,790,529,261,8.6,6.0,2.6,6.0,4.0,2.0
05166004,"Brüggen, Burggemeinde",05,Nordrhein-Westfalen,15648,7677,7971,1765,1192,573,1657,1098,559,11.3,7.6,3.7,10.6,7.0,3.6
05166008,"Grefrath, Sport- und Freizeitgemeinde",05,Nordrhein-Westfalen,14914,7342,7572,1509,1016,493,1041,743,298,10.1,6.8,3.3,7.0,5.0,2.0
05166012,"Kempen, Stadt",05,Nordrhein-Westfalen,34837,16911,17926,3555,2419,1136,4161,2842,1319,10.2,6.9,3.3,11.9,8.2,3.8
05166016,"Nettetal, Stadt",05,Nordrhein-Westfalen,41964,20769,21195,4447,3133,1314,4026,2881,1145,10.6,7.5,3.1,9.6,6.9,2.7
05166020,Niederkrüchten,05,Nordrhein-Westfalen,15184,7487,7697,1454,974,480,1106,742,364,9.6,6.4,3.2,7.3,4.9,2.4
05166024,Schwalmtal,05,Nordrhein-Westfalen,19139,9441,9698,1893,1298,595,1637,1059,578,9.9,6.8,3.1,8.6,5.5,3.0
05166028,"Tönisvorst, Stadt",05,Nordrhein-Westfalen,29296,14301,14995,2847,1879,968,2901,1968,933,9.7,6.4,3.3,9.9,6.7,3.2
05166032,"Viersen, Stadt",05,Nordrhein-Westfalen,75931,36727,39204,7412,5132,2280,6864,4758,2106,9.8,6.8,3.0,9.0,6.3,2.8
05166036,"Willich, Stadt",05,Nordrhein-Westfalen,50748,24815,25933,4947,3286,1661,5002,3277,1725,9.7,6.5,3.3,9.9,6.5,3.4
05170004,Alpen,05,Nordrhein-Westfalen,12798,6375,6423,1321,955,366,1089,792,297,10.3,7.5,2.9,8.5,6.2,2.3
05170008,"Dinslaken, Stadt",05,Nordrhein-Westfalen,67452,32635,34817,6363,4741,1622,8264,6142,2122,9.4,7.0,2.4,12.3,9.1,3.1
05170012,"Hamminkeln, Stadt",05,Nordrhein-Westfalen,26996,13477,13519,3060,2206,854,2594,1834,760,11.3,8.2,3.2,9.6,6.8,2.8
05170016,Hünxe,05,Nordrhein-Westfalen,13771,6767,7004,1275,934,341,1253,916,337,9.3,6.8,2.5,9.1,6.7,2.4
05170020,"Kamp-Lintfort, Stadt",05,Nordrhein-Westfalen,37683,18588,19095,3965,3084,881,4131,3085,1046,10.5,8.2,2.3,11.0,8.2,2.8
05170024,"Moers, Stadt",05,Nordrhein-Westfalen,104529,50973,53556,9546,7138,2408,9964,7550,2414,9.1,6.8,2.3,9.5,7.2,2.3
05170028,"Neukirchen-Vluyn, Stadt",05,Nordrhein-Westfalen,27178,13184,13994,2614,1968,646,2509,1838,671,9.6,7.2,2.4,9.2,6.8,2.5
05170032,"Rheinberg, Stadt",05,Nordrhein-Westfalen,31023,15140,15883,2950,2142,808,2203,1634,569,9.5,6.9,2.6,7.1,5.3,1.8
05170036,Schermbeck,05,Nordrhein-Westfalen,13635,6750,6885,1498,1080,418,1542,1094,448,11.0,7.9,3.1,11.3,8.0,3.3
05170040,Sonsbeck,05,Nordrhein-Westfalen,8819,4363,4456,997,691,306,1409,994,415,11.3,7.8,3.5,16.0,11.3,4.7
05170044,"Voerde (Niederrhein), Stadt",05,Nordrhein-Westfalen,36675,18073,18602,3478,2625,853,2362,1789,573,9.5,7.2,2.3,6.4,4.9,1.6
05170048,"Wesel, Stadt",05,Nordrhein-Westfalen,60595,29522,31073,6048,4435,1613,6595,4909,1686,10.0,7.3,2.7,10.9,8.1,2.8
05170052,"Xanten, Stadt",05,Nordrhein-Westfalen,21510,10549,10961,2339,1695,644,2055,1528,527,10.9,7.9,3.0,9.6,7.1,2.5
05314000,"Bonn, Stadt",05,Nordrhein-Westfalen,318809,151954,166855,29483,19926,9557,37808,25881,11927,9.2,6.3,3.0,11.9,8.1,3.7
05315000,"Köln, Stadt",05,Nordrhein-Westfalen,1060582,516976,543606,98699,66046,32653,112571,75417,37154,9.3,6.2,3.1,10.6,7.1,3.5
05316000,"Leverkusen, Stadt",05,Nordrhein-Westfalen,163487,79590,83897,14107,9741,4366,12744,8877,3867,8.6,6.0,2.7,7.8,5.4,2.4
05334002,"Aachen, Stadt",05,Nordrhein-Westfalen,245885,127613,118272,28020,21347,6673,34989,26111,8878,11.4,8.7,2.7,14.2,10.6,3.6
05334004,"Alsdorf, Stadt",05,Nordrhein-Westfalen,46880,23281,23599,4831,3460,1371,3440,2488,952,10.3,7.4,2.9,7.3,5.3,2.0
05334008,"Baesweiler, Stadt",05,Nordrhein-Westfalen,26819,13120,13699,2807,1985,822,2162,1566,596,10.5,7.4,3.1,8.1,5.8,2.2
05334012,"Eschweiler, Stadt",05,Nordrhein-Westfalen,55909,27322,28587,5674,4102,1572,5155,3727,1428,10.1,7.3,2.8,9.2,6.7,2.6
05334016,"Herzogenrath, Stadt",05,Nordrhein-Westfalen,46583,22665,23918,4447,3123,1324,3029,2190,839,9.5,6.7,2.8,6.5,4.7,1.8
05334020,"Monschau, Stadt",05,Nordrhein-Westfalen,12352,6234,6118,1613,1071,542,2098,1474,624,13.1,8.7,4.4,17.0,11.9,5.1
05334024,"Roetgen, Tor zur Eifel",05,Nordrhein-Westfalen,8527,4214,4313,804,554,250,691,475,216,9.4,6.5,2.9,8.1,5.6,2.5
05334028,Simmerath,05,Nordrhein-Westfalen,15266,7583,7683,2008,1332,676,1677,1114,563,13.2,8.7,4.4,11.0,7.3,3.7
05334032,"Stolberg (Rhld.), Kupferstadt",05,Nordrhein-Westfalen,56739,28112,28627,5872,4098,1774,4677,3281,1396,10.3,7.2,3.1,8.2,5.8,2.5
05334036,"Würselen, Stadt",05,Nordrhein-Westfalen,38962,19116,19846,3679,2515,1164,3646,2476,1170,9.4,6.5,3.0,9.4,6.4,3.0
05358004,Aldenhoven,05,Nordrhein-Westfalen,13932,6995,6937,1509,1101,408,1097,794,303,10.8,7.9,2.9,7.9,5.7,2.2
05358008,"Düren, Stadt",05,Nordrhein-Westfalen,90244,44599,45645,9134,6590,2544,12583,9042,3541,10.1,7.3,2.8,13.9,10.0,3.9
05358012,"Heimbach, Stadt",05,Nordrhein-Westfalen,4366,2203,2163,518,379,139,473,332,141,11.9,8.7,3.2,10.8,7.6,3.2
05358016,Hürtgenwald,05,Nordrhein-Westfalen,8780,4426,4354,902,600,302,577,378,199,10.3,6.8,3.4,6.6,4.3,2.3
05358020,Inden,05,Nordrhein-Westfalen,7272,3579,3693,694,463,231,496,356,140,9.5,6.4,3.2,6.8,4.9,1.9
05358024,"Jülich, Stadt",05,Nordrhein-Westfalen,32601,16318,16283,3189,2322,867,3258,2389,869,9.8,7.1,2.7,10.0,7.3,2.7
05358028,Kreuzau,05,Nordrhein-Westfalen,17441,8579,8862,1869,1300,569,1265,903,362,10.7,7.5,3.3,7.3,5.2,2.1
05358032,Langerwehe,05,Nordrhein-Westfalen,13791,6871,6920,1419,1018,401,937,685,252,10.3,7.4,2.9,6.8,5.0,1.8
05358036,"Linnich, Stadt",05,Nordrhein-Westfalen,12591,6253,6338,1323,943,380,843,577,266,10.5,7.5,3.0,6.7,4.6,2.1
05358040,Merzenich,05,Nordrhein-Westfalen,9950,4948,5002,986,693,293,2130,1359,771,9.9,7.0,2.9,21.4,13.7,7.7
05358044,"Nideggen, Stadt",05,Nordrhein-Westfalen,9893,4832,5061,1135,808,327,845,601,244,11.5,8.2,3.3,8.5,6.1,2.5
05358048,Niederzier,05,Nordrhein-Westfalen,13915,6876,7039,1466,1028,438,1060,754,306,10.5,7.4,3.1,7.6,5.4,2.2
05358052,Nörvenich,05,Nordrhein-Westfalen,10552,5249,5303,1104,760,344,565,407,158,10.5,7.2,3.3,5.4,3.9,1.5
05358056,Titz,05,Nordrhein-Westfalen,8277,4150,4127,749,516,233,477,341,136,9.0,6.2,2.8,5.8,4.1,1.6
05358060,Vettweiß,05,Nordrhein-Westfalen,9223,4644,4579,971,698,273,492,337,155,10.5,7.6,3.0,5.3,3.7,1.7
05362004,"Bedburg, Stadt",05,Nordrhein-Westfalen,23334,11676,11658,2266,1590,676,1922,1348,574,9.7,6.8,2.9,8.2,5.8,2.5
05362008,"Bergheim, Stadt",05,Nordrhein-Westfalen,60390,29779,30611,5892,4090,1802,5382,3701,1681,9.8,6.8,3.0,8.9,6.1,2.8
05362012,"Brühl, Stadt",05,Nordrhein-Westfalen,44768,21443,23325,4048,2732,1316,3764,2502,1262,9.0,6.1,2.9,8.4,5.6,2.8
05362016,"Elsdorf, Stadt",05,Nordrhein-Westfalen,21232,10453,10779,1942,1329,613,1551,1071,480,9.1,6.3,2.9,7.3,5.0,2.3
05362020,"Erftstadt, Stadt",05,Nordrhein-Westfalen,49786,24168,25618,4273,2966,1307,3723,2602,1121,8.6,6.0,2.6,7.5,5.2,2.3
05362024,"Frechen, Stadt",05,Nordrhein-Westfalen,51999,25311,26688,4883,3207,1676,4984,3215,1769,9.4,6.2,3.2,9.6,6.2,3.4
05362028,"Hürth, Stadt",05,Nordrhein-Westfalen,59496,29173,30323,5691,3729,1962,5744,3764,1980,9.6,6.3,3.3,9.7,6.3,3.3
05362032,"Kerpen, Kolpingstadt",05,Nordrhein-Westfalen,65477,32337,33140,6388,4289,2099,6680,4154,2526,9.8,6.6,3.2,10.2,6.3,3.9
05362036,"Pulheim, Stadt",05,Nordrhein-Westfalen,54200,26267,27933,4563,3058,1505,5525,3643,1882,8.4,5.6,2.8,10.2,6.7,3.5
05362040,"Wesseling, Stadt",05,Nordrhein-Westfalen,35975,17843,18132,3544,2428,1116,2797,1856,941,9.9,6.7,3.1,7.8,5.2,2.6
05366004,"Bad Münstereifel, Stadt",05,Nordrhein-Westfalen,17367,8536,8831,1825,1248,577,1447,1000,447,10.5,7.2,3.3,8.3,5.8,2.6
05366008,Blankenheim,05,Nordrhein-Westfalen,8471,4343,4128,856,587,269,752,494,258,10.1,6.9,3.2,8.9,5.8,3.0
05366012,Dahlem,05,Nordrhein-Westfalen,4236,2085,2151,502,354,148,311,229,82,11.9,8.4,3.5,7.3,5.4,1.9
05366016,"Euskirchen, Stadt",05,Nordrhein-Westfalen,56769,27854,28915,5587,3803,1784,5497,3783,1714,9.8,6.7,3.1,9.7,6.7,3.0
05366020,Hellenthal,05,Nordrhein-Westfalen,8094,4125,3969,929,615,314,565,367,198,11.5,7.6,3.9,7.0,4.5,2.4
05366024,Kall,05,Nordrhein-Westfalen,11229,5606,5623,1216,822,394,1768,1085,683,10.8,7.3,3.5,15.7,9.7,6.1
05366028,"Mechernich, Stadt",05,Nordrhein-Westfalen,27170,13551,13619,2729,1880,849,2205,1482,723,10.0,6.9,3.1,8.1,5.5,2.7
05366032,Nettersheim,05,Nordrhein-Westfalen,7469,3713,3756,839,541,298,598,392,206,11.2,7.2,4.0,8.0,5.2,2.8
05366036,"Schleiden, Stadt",05,Nordrhein-Westfalen,13272,6623,6649,1513,1021,492,1496,1028,468,11.4,7.7,3.7,11.3,7.7,3.5
05366040,Weilerswist,05,Nordrhein-Westfalen,16997,8404,8593,1571,1027,544,998,683,315,9.2,6.0,3.2,5.9,4.0,1.9
05366044,"Zülpich, Stadt",05,Nordrhein-Westfalen,20091,9919,10172,2079,1415,664,1853,1231,622,10.3,7.0,3.3,9.2,6.1,3.1
05370004,"Erkelenz, Stadt",05,Nordrhein-Westfalen,43350,21170,22180,4386,3058,1328,4665,3352,1313,10.1,7.1,3.1,10.8,7.7,3.0
05370008,Gangelt,05,Nordrhein-Westfalen,12015,6002,6013,1187,847,340,1190,885,305,9.9,7.0,2.8,9.9,7.4,2.5
05370012,"Geilenkirchen, Stadt",05,Nordrhein-Westfalen,26963,13424,13539,3006,2135,871,2941,2096,845,11.1,7.9,3.2,10.9,7.8,3.1
05370016,"Heinsberg, Stadt",05,Nordrhein-Westfalen,41538,20387,21151,4323,3139,1184,5378,3980,1398,10.4,7.6,2.9,12.9,9.6,3.4
05370020,"Hückelhoven, Stadt",05,Nordrhein-Westfalen,39531,19537,19994,3967,2903,1064,3134,2324,810,10.0,7.3,2.7,7.9,5.9,2.0
05370024,Selfkant,05,Nordrhein-Westfalen,10167,5173,4994,794,623,171,730,577,153,7.8,6.1,1.7,7.2,5.7,1.5
05370028,"Übach-Palenberg, Stadt",05,Nordrhein-Westfalen,24377,12270,12107,2594,1932,662,2215,1650,565,10.6,7.9,2.7,9.1,6.8,2.3
05370032,Waldfeucht,05,Nordrhein-Westfalen,8861,4447,4414,876,665,211,709,553,156,9.9,7.5,2.4,8.0,6.2,1.8
05370036,"Wassenberg, Stadt",05,Nordrhein-Westfalen,17898,8889,9009,1734,1233,501,1347,975,372,9.7,6.9,2.8,7.5,5.4,2.1
05370040,"Wegberg, Stadt",05,Nordrhein-Westfalen,27827,13657,14170,2816,1962,854,2412,1695,717,10.1,7.1,3.1,8.7,6.1,2.6
05374004,"Bergneustadt, Stadt",05,Nordrhein-Westfalen,18940,9294,9646,1911,1365,546,1315,937,378,10.1,7.2,2.9,6.9,4.9,2.0
05374008,Engelskirchen,05,Nordrhein-Westfalen,19307,9395,9912,2043,1300,743,1902,1215,687,10.6,6.7,3.8,9.9,6.3,3.6
05374012,"Gummersbach, Stadt",05,Nordrhein-Westfalen,50412,24870,25542,5477,3648,1829,5957,4008,1949,10.9,7.2,3.6,11.8,8.0,3.9
05374016,"Hückeswagen, Schloss-Stadt",05,Nordrhein-Westfalen,15275,7620,7655,1629,1099,530,1354,901,453,10.7,7.2,3.5,8.9,5.9,3.0
05374020,Lindlar,05,Nordrhein-Westfalen,21382,10491,10891,2536,1695,841,2188,1469,719,11.9,7.9,3.9,10.2,6.9,3.4
05374024,Marienheide,05,Nordrhein-Westfalen,13560,6750,6810,1423,924,499,1017,647,370,10.5,6.8,3.7,7.5,4.8,2.7
05374028,Morsbach,05,Nordrhein-Westfalen,10402,5228,5174,1214,844,370,998,649,349,11.7,8.1,3.6,9.6,6.2,3.4
05374032,Nümbrecht,05,Nordrhein-Westfalen,17002,8310,8692,1690,1104,586,1335,871,464,9.9,6.5,3.4,7.9,5.1,2.7
05374036,"Radevormwald, Stadt auf der Höhe",05,Nordrhein-Westfalen,22386,10916,11470,2397,1587,810,2310,1488,822,10.7,7.1,3.6,10.3,6.6,3.7
05374040,Reichshof,05,Nordrhein-Westfalen,18837,9499,9338,1971,1319,652,2413,1531,882,10.5,7.0,3.5,12.8,8.1,4.7
05374044,"Waldbröl, Stadt",05,Nordrhein-Westfalen,19194,9389,9805,1941,1275,666,1738,1191,547,10.1,6.6,3.5,9.1,6.2,2.8
05374048,"Wiehl, Stadt",05,Nordrhein-Westfalen,25274,12253,13021,2653,1734,919,3628,2346,1282,10.5,6.9,3.6,14.4,9.3,5.1
05374052,"Wipperfürth, Hansestadt",05,Nordrhein-Westfalen,21481,10655,10826,2721,1791,930,2490,1646,844,12.7,8.3,4.3,11.6,7.7,3.9
05378004,"Bergisch Gladbach, Stadt",05,Nordrhein-Westfalen,111366,53479,57887,10327,6960,3367,10797,7252,3545,9.3,6.2,3.0,9.7,6.5,3.2
05378008,"Burscheid, Stadt",05,Nordrhein-Westfalen,18256,9037,9219,1826,1241,585,1594,1099,495,10.0,6.8,3.2,8.7,6.0,2.7
05378012,Kürten,05,Nordrhein-Westfalen,19893,9823,10070,2213,1505,708,2083,1299,784,11.1,7.6,3.6,10.5,6.5,3.9
05378016,"Leichlingen (Rheinland), Blütenstadt",05,Nordrhein-Westfalen,27937,13468,14469,2378,1662,716,2223,1521,702,8.5,5.9,2.6,8.0,5.4,2.5
05378020,Odenthal,05,Nordrhein-Westfalen,15123,7456,7667,1332,875,457,867,561,306,8.8,5.8,3.0,5.7,3.7,2.0
05378024,"Overath, Stadt",05,Nordrhein-Westfalen,27264,13439,13825,2870,1911,959,2574,1711,863,10.5,7.0,3.5,9.4,6.3,3.2
05378028,"Rösrath, Stadt",05,Nordrhein-Westfalen,28386,13934,14452,2624,1735,889,2178,1485,693,9.2,6.1,3.1,7.7,5.2,2.4
05378032,"Wermelskirchen, Stadt",05,Nordrhein-Westfalen,34504,16802,17702,3619,2403,1216,3666,2422,1244,10.5,7.0,3.5,10.6,7.0,3.6
05382004,Alfter,05,Nordrhein-Westfalen,23435,11515,11920,2324,1467,857,1296,836,460,9.9,6.3,3.7,5.5,3.6,2.0
05382008,"Bad Honnef, Stadt",05,Nordrhein-Westfalen,25654,12337,13317,2495,1640,855,3307,2216,1091,9.7,6.4,3.3,12.9,8.6,4.3
05382012,"Bornheim, Stadt",05,Nordrhein-Westfalen,47636,23280,24356,4553,2912,1641,4240,2743,1497,9.6,6.1,3.4,8.9,5.8,3.1
05382016,Eitorf,05,Nordrhein-Westfalen,18864,9428,9436,1827,1285,542,1538,1082,456,9.7,6.8,2.9,8.2,5.7,2.4
05382020,"Hennef (Sieg), Stadt",05,Nordrhein-Westfalen,46902,22868,24034,4673,3072,1601,4184,2745,1439,10.0,6.5,3.4,8.9,5.9,3.1
05382024,"Königswinter, Stadt",05,Nordrhein-Westfalen,40702,19858,20844,3754,2487,1267,2943,1990,953,9.2,6.1,3.1,7.2,4.9,2.3
05382028,"Lohmar, Stadt",05,Nordrhein-Westfalen,30348,14915,15433,2718,1837,881,5995,4330,1665,9.0,6.1,2.9,19.8,14.3,5.5
05382032,"Meckenheim, Stadt",05,Nordrhein-Westfalen,24357,11905,12452,2229,1526,703,2468,1600,868,9.2,6.3,2.9,10.1,6.6,3.6
05382036,Much,05,Nordrhein-Westfalen,14468,7078,7390,1459,977,482,1086,692,394,10.1,6.8,3.3,7.5,4.8,2.7
05382040,Neunkirchen-Seelscheid,05,Nordrhein-Westfalen,19862,9811,10051,1848,1217,631,1425,984,441,9.3,6.1,3.2,7.2,5.0,2.2
05382044,"Niederkassel, Stadt",05,Nordrhein-Westfalen,37583,18543,19040,3447,2201,1246,2234,1494,740,9.2,5.9,3.3,5.9,4.0,2.0
05382048,"Rheinbach, Stadt",05,Nordrhein-Westfalen,27224,13508,13716,2728,1848,880,2839,1947,892,10.0,6.8,3.2,10.4,7.2,3.3
05382052,Ruppichteroth,05,Nordrhein-Westfalen,10461,5126,5335,971,680,291,558,382,176,9.3,6.5,2.8,5.3,3.7,1.7
05382056,"Sankt Augustin, Stadt",05,Nordrhein-Westfalen,55709,27246,28463,4891,3205,1686,3966,2593,1373,8.8,5.8,3.0,7.1,4.7,2.5
05382060,"Siegburg, Stadt",05,Nordrhein-Westfalen,41016,20169,20847,3846,2469,1377,4763,3137,1626,9.4,6.0,3.4,11.6,7.6,4.0
05382064,Swisttal,05,Nordrhein-Westfalen,18204,8995,9209,1631,1072,559,1053,704,349,9.0,5.9,3.1,5.8,3.9,1.9
05382068,"Troisdorf, Stadt",05,Nordrhein-Westfalen,74400,36404,37996,7369,4680,2689,7330,4747,2583,9.9,6.3,3.6,9.9,6.4,3.5
05382072,Wachtberg,05,Nordrhein-Westfalen,20457,10090,10367,1822,1151,671,1340,891,449,8.9,5.6,3.3,6.6,4.4,2.2
05382076,Windeck,05,Nordrhein-Westfalen,18931,9479,9452,1738,1251,487,1211,863,348,9.2,6.6,2.6,6.4,4.6,1.8
05512000,"Bottrop, Stadt",05,Nordrhein-Westfalen,117143,57004,60139,10999,8402,2597,10060,7727,2333,9.4,7.2,2.2,8.6,6.6,2.0
05513000,"Gelsenkirchen, Stadt",05,Nordrhein-Westfalen,260368,129267,131101,22552,17336,5216,23828,17963,5865,8.7,6.7,2.0,9.2,6.9,2.3
05515000,"Münster, Stadt",05,Nordrhein-Westfalen,310039,148447,161592,34282,24009,10273,38622,27137,11485,11.1,7.7,3.3,12.5,8.8,3.7
05554004,"Ahaus, Stadt",05,Nordrhein-Westfalen,39277,19613,19664,6013,4092,1921,6940,4767,2173,15.3,10.4,4.9,17.7,12.1,5.5
05554008,"Bocholt, Stadt",05,Nordrhein-Westfalen,71443,35039,36404,9043,6411,2632,9831,7058,2773,12.7,9.0,3.7,13.8,9.9,3.9
05554012,"Borken, Stadt",05,Nordrhein-Westfalen,42272,20803,21469,5319,3659,1660,5896,4210,1686,12.6,8.7,3.9,13.9,10.0,4.0
05554016,"Gescher, Glockenstadt",05,Nordrhein-Westfalen,17118,8644,8474,2184,1544,640,1962,1408,554,12.8,9.0,3.7,11.5,8.2,3.2
05554020,"Gronau (Westf.), Stadt",05,Nordrhein-Westfalen,47010,23468,23542,5623,4084,1539,5339,3972,1367,12.0,8.7,3.3,11.4,8.4,2.9
05554024,Heek,05,Nordrhein-Westfalen,8505,4315,4190,1218,856,362,1057,737,320,14.3,10.1,4.3,12.4,8.7,3.8
05554028,Heiden,05,Nordrhein-Westfalen,8152,4127,4025,1041,727,314,905,643,262,12.8,8.9,3.9,11.1,7.9,3.2
05554032,"Isselburg, Stadt",05,Nordrhein-Westfalen,10736,5387,5349,1437,1021,416,1119,803,316,13.4,9.5,3.9,10.4,7.5,2.9
05554036,Legden,05,Nordrhein-Westfalen,7254,3794,3460,997,689,308,1046,680,366,13.7,9.5,4.2,14.4,9.4,5.0
05554040,Raesfeld,05,Nordrhein-Westfalen,11378,5735,5643,1454,1024,430,1382,953,429,12.8,9.0,3.8,12.1,8.4,3.8
05554044,Reken,05,Nordrhein-Westfalen,14532,7398,7134,1741,1212,529,1452,1011,441,12.0,8.3,3.6,10.0,7.0,3.0
05554048,"Rhede, Stadt",05,Nordrhein-Westfalen,19284,9622,9662,2370,1693,677,2031,1374,657,12.3,8.8,3.5,10.5,7.1,3.4
05554052,Schöppingen,05,Nordrhein-Westfalen,7280,3895,3385,921,633,288,892,597,295,12.7,8.7,4.0,12.3,8.2,4.1
05554056,"Stadtlohn, Stadt",05,Nordrhein-Westfalen,20411,10267,10144,3119,2048,1071,3157,2072,1085,15.3,10.0,5.2,15.5,10.2,5.3
05554060,Südlohn,05,Nordrhein-Westfalen,9134,4542,4592,1271,869,402,1229,831,398,13.9,9.5,4.4,13.5,9.1,4.4
05554064,"Velen, Stadt",05,Nordrhein-Westfalen,13192,6737,6455,1725,1225,500,1388,948,440,13.1,9.3,3.8,10.5,7.2,3.3
05554068,"Vreden, Stadt",05,Nordrhein-Westfalen,22688,11587,11101,3720,2482,1238,3395,2223,1172,16.4,10.9,5.5,15.0,9.8,5.2
05558004,Ascheberg,05,Nordrhein-Westfalen,15253,7618,7635,1600,1128,472,1707,1228,479,10.5,7.4,3.1,11.2,8.1,3.1
05558008,"Billerbeck, Stadt",05,Nordrhein-Westfalen,11593,5812,5781,1342,904,438,1267,875,392,11.6,7.8,3.8,10.9,7.5,3.4
05558012,"Coesfeld, Stadt",05,Nordrhein-Westfalen,36116,17738,18378,4286,2904,1382,4696,3268,1428,11.9,8.0,3.8,13.0,9.0,4.0
05558016,"Dülmen, Stadt",05,Nordrhein-Westfalen,46613,22685,23928,5004,3522,1482,4214,2939,1275,10.7,7.6,3.2,9.0,6.3,2.7
05558020,Havixbeck,05,Nordrhein-Westfalen,11689,5732,5957,1210,820,390,953,655,298,10.4,7.0,3.3,8.2,5.6,2.5
05558024,"Lüdinghausen, Stadt",05,Nordrhein-Westfalen,24263,12054,12209,2563,1805,758,2681,1919,762,10.6,7.4,3.1,11.0,7.9,3.1
05558028,Nordkirchen,05,Nordrhein-Westfalen,9781,4845,4936,1026,724,302,943,673,270,10.5,7.4,3.1,9.6,6.9,2.8
05558032,Nottuln,05,Nordrhein-Westfalen,19436,9641,9795,2143,1452,691,1704,1139,565,11.0,7.5,3.6,8.8,5.9,2.9
05558036,"Olfen, Stadt",05,Nordrhein-Westfalen,12490,6145,6345,1250,905,345,1151,816,335,10.0,7.2,2.8,9.2,6.5,2.7
05558040,Rosendahl,05,Nordrhein-Westfalen,10712,5507,5205,1337,872,465,982,631,351,12.5,8.1,4.3,9.2,5.9,3.3
05558044,Senden,05,Nordrhein-Westfalen,20455,10176,10279,2209,1482,727,1692,1137,555,10.8,7.2,3.6,8.3,5.6,2.7
05562004,"Castrop-Rauxel, Stadt",05,Nordrhein-Westfalen,74220,36210,38010,6411,4719,1692,5944,4407,1537,8.6,6.4,2.3,8.0,5.9,2.1
05562008,"Datteln, Stadt",05,Nordrhein-Westfalen,34521,16922,17599,3277,2505,772,3152,2471,681,9.5,7.3,2.2,9.1,7.2,2.0
05562012,"Dorsten, Stadt",05,Nordrhein-Westfalen,75431,36714,38717,7808,5949,1859,7077,5333,1744,10.4,7.9,2.5,9.4,7.1,2.3
05562014,"Gladbeck, Stadt",05,Nordrhein-Westfalen,75455,36801,38654,7205,5576,1629,5985,4686,1299,9.5,7.4,2.2,7.9,6.2,1.7
05562016,"Haltern am See, Stadt",05,Nordrhein-Westfalen,38020,18535,19485,3587,2629,958,3506,2579,927,9.4,6.9,2.5,9.2,6.8,2.4
05562020,"Herten, Stadt",05,Nordrhein-Westfalen,61163,29875,31288,5493,4298,1195,4534,3580,954,9.0,7.0,2.0,7.4,5.9,1.6
05562024,"Marl, Stadt",05,Nordrhein-Westfalen,83926,41288,42638,7707,5980,1727,7211,5549,1662,9.2,7.1,2.1,8.6,6.6,2.0
05562028,"Oer-Erkenschwick, Stadt",05,Nordrhein-Westfalen,31387,15553,15834,2668,2108,560,1685,1321,364,8.5,6.7,1.8,5.4,4.2,1.2
05562032,"Recklinghausen, Stadt",05,Nordrhein-Westfalen,114330,55697,58633,10707,8143,2564,10045,7650,2395,9.4,7.1,2.2,8.8,6.7,2.1
05562036,"Waltrop, Stadt",05,Nordrhein-Westfalen,29354,14298,15056,2802,2117,685,2292,1800,492,9.5,7.2,2.3,7.8,6.1,1.7
05566004,Altenberge,05,Nordrhein-Westfalen,10315,5201,5114,1075,718,357,975,634,341,10.4,7.0,3.5,9.5,6.1,3.3
05566008,"Emsdetten, Stadt",05,Nordrhein-Westfalen,36320,18009,18311,4412,2979,1433,4573,3136,1437,12.1,8.2,3.9,12.6,8.6,4.0
05566012,"Greven, Stadt",05,Nordrhein-Westfalen,36674,18087,18587,4072,2684,1388,4660,3108,1552,11.1,7.3,3.8,12.7,8.5,4.2
05566016,"Hörstel, Stadt",05,Nordrhein-Westfalen,19995,10048,9947,2515,1760,755,2191,1554,637,12.6,8.8,3.8,11.0,7.8,3.2
05566020,Hopsten,05,Nordrhein-Westfalen,7642,3973,3669,1072,732,340,828,551,277,14.0,9.6,4.4,10.8,7.2,3.6
05566024,"Horstmar, Stadt der Burgmannshöfe",05,Nordrhein-Westfalen,6447,3274,3173,696,501,195,583,431,152,10.8,7.8,3.0,9.0,6.7,2.4
05566028,"Ibbenbüren, Stadt",05,Nordrhein-Westfalen,50935,25176,25759,6097,4281,1816,6210,4396,1814,12.0,8.4,3.6,12.2,8.6,3.6
05566032,Ladbergen,05,Nordrhein-Westfalen,6694,3321,3373,757,472,285,758,504,254,11.3,7.1,4.3,11.3,7.5,3.8
05566036,Laer,05,Nordrhein-Westfalen,6721,3370,3351,713,499,214,595,423,172,10.6,7.4,3.2,8.9,6.3,2.6
05566040,"Lengerich, Stadt",05,Nordrhein-Westfalen,22461,11129,11332,2373,1590,783,2014,1352,662,10.6,7.1,3.5,9.0,6.0,2.9
05566044,Lienen,05,Nordrhein-Westfalen,8559,4316,4243,921,616,305,621,424,197,10.8,7.2,3.6,7.3,5.0,2.3
05566048,Lotte,05,Nordrhein-Westfalen,14175,7094,7081,1771,1128,643,738,456,282,12.5,8.0,4.5,5.2,3.2,2.0
05566052,Metelen,05,Nordrhein-Westfalen,6461,3262,3199,748,537,211,488,341,147,11.6,8.3,3.3,7.6,5.3,2.3
05566056,Mettingen,05,Nordrhein-Westfalen,11815,5875,5940,1510,1074,436,1118,821,297,12.8,9.1,3.7,9.5,6.9,2.5
05566060,Neuenkirchen,05,Nordrhein-Westfalen,13743,6908,6835,1806,1297,509,1688,1209,479,13.1,9.4,3.7,12.3,8.8,3.5
05566064,Nordwalde,05,Nordrhein-Westfalen,9388,4650,4738,1137,777,360,1039,689,350,12.1,8.3,3.8,11.1,7.3,3.7
05566068,"Ochtrup, Stadt",05,Nordrhein-Westfalen,19599,9922,9677,2530,1751,779,2272,1607,665,12.9,8.9,4.0,11.6,8.2,3.4
05566072,Recke,05,Nordrhein-Westfalen,11363,5661,5702,1693,1213,480,1694,1213,481,14.9,10.7,4.2,14.9,10.7,4.2
05566076,"Rheine, Stadt",05,Nordrhein-Westfalen,74852,36911,37941,8829,6184,2645,9137,6447,2690,11.8,8.3,3.5,12.2,8.6,3.6
05566080,"Saerbeck, NRW-Klimakommune",05,Nordrhein-Westfalen,7191,3639,3552,871,573,298,859,509,350,12.1,8.0,4.1,11.9,7.1,4.9
05566084,"Steinfurt, Stadt",05,Nordrhein-Westfalen,33682,16719,16963,3980,2836,1144,3854,2817,1037,11.8,8.4,3.4,11.4,8.4,3.1
05566088,"Tecklenburg, Stadt",05,Nordrhein-Westfalen,9062,4573,4489,938,647,291,959,636,323,10.4,7.1,3.2,10.6,7.0,3.6
05566092,Westerkappeln,05,Nordrhein-Westfalen,11178,5582,5596,1287,867,420,1529,998,531,11.5,7.8,3.8,13.7,8.9,4.8
05566096,Wettringen,05,Nordrhein-Westfalen,8102,4082,4020,1057,756,301,1034,701,333,13.0,9.3,3.7,12.8,8.7,4.1
05570004,"Ahlen, Stadt",05,Nordrhein-Westfalen,52287,25551,26736,5748,4282,1466,5213,3898,1315,11.0,8.2,2.8,10.0,7.5,2.5
05570008,"Beckum, Stadt",05,Nordrhein-Westfalen,36560,18089,18471,3997,2762,1235,3949,2642,1307,10.9,7.6,3.4,10.8,7.2,3.6
05570012,Beelen,05,Nordrhein-Westfalen,6380,3217,3163,844,566,278,643,403,240,13.2,8.9,4.4,10.1,6.3,3.8
05570016,"Drensteinfurt, Stadt",05,Nordrhein-Westfalen,15542,7757,7785,1513,1067,446,1204,852,352,9.7,6.9,2.9,7.7,5.5,2.3
05570020,"Ennigerloh, Stadt",05,Nordrhein-Westfalen,20037,10075,9962,2156,1468,688,1615,1123,492,10.8,7.3,3.4,8.1,5.6,2.5
05570024,Everswinkel,05,Nordrhein-Westfalen,9583,4766,4817,999,633,366,1069,626,443,10.4,6.6,3.8,11.2,6.5,4.6
05570028,"Oelde, Stadt",05,Nordrhein-Westfalen,29299,14660,14639,3296,2235,1061,2936,2060,876,11.2,7.6,3.6,10.0,7.0,3.0
05570032,Ostbevern,05,Nordrhein-Westfalen,10873,5438,5435,1314,843,471,1088,689,399,12.1,7.8,4.3,10.0,6.3,3.7
05570036,"Sassenberg, Stadt",05,Nordrhein-Westfalen,14403,7263,7140,1835,1123,712,1267,781,486,12.7,7.8,4.9,8.8,5.4,3.4
05570040,"Sendenhorst, Stadt",05,Nordrhein-Westfalen,13218,6583,6635,1577,1077,500,1285,897,388,11.9,8.1,3.8,9.7,6.8,2.9
05570044,"Telgte, Stadt",05,Nordrhein-Westfalen,19557,9461,10096,2077,1371,706,1982,1307,675,10.6,7.0,3.6,10.1,6.7,3.5
05570048,Wadersloh,05,Nordrhein-Westfalen,12443,6318,6125,1494,1022,472,1270,823,447,12.0,8.2,3.8,10.2,6.6,3.6
05570052,"Warendorf, Stadt",05,Nordrhein-Westfalen,37249,18087,19162,4461,2936,1525,4748,3286,1462,12.0,7.9,4.1,12.7,8.8,3.9
05711000,"Bielefeld, Stadt",05,Nordrhein-Westfalen,333090,161148,171942,31661,21417,10244,36045,23988,12057,9.5,6.4,3.1,10.8,7.2,3.6
05754004,"Borgholzhausen, Stadt",05,Nordrhein-Westfalen,8801,4357,4444,904,574,330,733,441,292,10.3,6.5,3.7,8.3,5.0,3.3
05754008,"Gütersloh, Stadt",05,Nordrhein-Westfalen,97586,48366,49220,9990,6456,3534,10352,6956,3396,10.2,6.6,3.6,10.6,7.1,3.5
05754012,"Halle (Westf.), Stadt",05,Nordrhein-Westfalen,21709,10770,10939,2145,1342,803,2672,1873,799,9.9,6.2,3.7,12.3,8.6,3.7
05754016,"Harsewinkel, Die Mähdrescherstadt",05,Nordrhein-Westfalen,24769,12571,12198,2847,1867,980,3045,1961,1084,11.5,7.5,4.0,12.3,7.9,4.4
05754020,Herzebrock-Clarholz,05,Nordrhein-Westfalen,15965,7982,7983,1962,1301,661,1680,1108,572,12.3,8.1,4.1,10.5,6.9,3.6
05754024,Langenberg,05,Nordrhein-Westfalen,8375,4236,4139,988,605,383,726,451,275,11.8,7.2,4.6,8.7,5.4,3.3
05754028,"Rheda-Wiedenbrück, Stadt",05,Nordrhein-Westfalen,48000,23902,24098,5407,3457,1950,5571,3522,2049,11.3,7.2,4.1,11.6,7.3,4.3
05754032,"Rietberg, Stadt",05,Nordrhein-Westfalen,29436,14901,14535,3894,2512,1382,3939,2494,1445,13.2,8.5,4.7,13.4,8.5,4.9
05754036,"Schloß Holte-Stukenbrock, Stadt",05,Nordrhein-Westfalen,27092,13435,13657,3005,1989,1016,2514,1598,916,11.1,7.3,3.8,9.3,5.9,3.4
05754040,Steinhagen,05,Nordrhein-Westfalen,20749,10242,10507,2097,1370,727,3121,2029,1092,10.1,6.6,3.5,15.0,9.8,5.3
05754044,"Verl, Stadt",05,Nordrhein-Westfalen,25512,13060,12452,2893,1891,1002,3146,1967,1179,11.3,7.4,3.9,12.3,7.7,4.6
05754048,"Versmold, Stadt",05,Nordrhein-Westfalen,21230,10686,10544,2572,1536,1036,2364,1335,1029,12.1,7.2,4.9,11.1,6.3,4.8
05754052,"Werther (Westf.), Stadt",05,Nordrhein-Westfalen,11418,5714,5704,1090,725,365,896,579,317,9.5,6.3,3.2,7.8,5.1,2.8
05758004,"Bünde, Stadt",05,Nordrhein-Westfalen,45615,22277,23338,4379,2801,1578,4074,2750,1324,9.6,6.1,3.5,8.9,6.0,2.9
05758008,"Enger, Widukindstadt",05,Nordrhein-Westfalen,20658,10193,10465,1898,1195,703,1633,976,657,9.2,5.8,3.4,7.9,4.7,3.2
05758012,"Herford, Hansestadt",05,Nordrhein-Westfalen,66521,32485,34036,6106,4022,2084,7099,4636,2463,9.2,6.0,3.1,10.7,7.0,3.7
05758016,Hiddenhausen,05,Nordrhein-Westfalen,19758,9805,9953,1679,1044,635,1380,894,486,8.5,5.3,3.2,7.0,4.5,2.5
05758020,Kirchlengern,05,Nordrhein-Westfalen,16085,7896,8189,1436,962,474,1460,952,508,8.9,6.0,2.9,9.1,5.9,3.2
05758024,"Löhne, Stadt",05,Nordrhein-Westfalen,40086,19759,20327,3673,2435,1238,2820,1929,891,9.2,6.1,3.1,7.0,4.8,2.2
05758028,Rödinghausen,05,Nordrhein-Westfalen,9717,4841,4876,962,606,356,774,489,285,9.9,6.2,3.7,8.0,5.0,2.9
05758032,"Spenge, Stadt",05,Nordrhein-Westfalen,14768,7232,7536,1298,861,437,1040,679,361,8.8,5.8,3.0,7.0,4.6,2.4
05758036,"Vlotho, Stadt",05,Nordrhein-Westfalen,18914,9447,9467,1739,1161,578,1435,970,465,9.2,6.1,3.1,7.6,5.1,2.5
05762004,"Bad Driburg, Stadt",05,Nordrhein-Westfalen,18699,9140,9559,1956,1352,604,2048,1465,583,10.5,7.2,3.2,11.0,7.8,3.1
05762008,"Beverungen, Stadt",05,Nordrhein-Westfalen,13442,6641,6801,1360,1004,356,986,739,247,10.1,7.5,2.6,7.3,5.5,1.8
05762012,"Borgentreich, Orgelstadt",05,Nordrhein-Westfalen,9497,4944,4553,816,574,242,600,412,188,8.6,6.0,2.5,6.3,4.3,2.0
05762016,"Brakel, Stadt",05,Nordrhein-Westfalen,16586,8368,8218,1539,1097,442,1416,997,419,9.3,6.6,2.7,8.5,6.0,2.5
05762020,"Höxter, Stadt",05,Nordrhein-Westfalen,29589,14691,14898,2704,2021,683,2612,1975,637,9.1,6.8,2.3,8.8,6.7,2.2
05762024,"Marienmünster, Stadt",05,Nordrhein-Westfalen,5125,2592,2533,477,344,133,402,294,108,9.3,6.7,2.6,7.8,5.7,2.1
05762028,"Nieheim, Stadt",05,Nordrhein-Westfalen,6254,3231,3023,621,450,171,462,315,147,9.9,7.2,2.7,7.4,5.0,2.4
05762032,"Steinheim, Stadt",05,Nordrhein-Westfalen,12922,6446,6476,1301,919,382,1458,1029,429,10.1,7.1,3.0,11.3,8.0,3.3
05762036,"Warburg, Hansestadt",05,Nordrhein-Westfalen,23629,11761,11868,2149,1545,604,2417,1760,657,9.1,6.5,2.6,10.2,7.4,2.8
05762040,"Willebadessen, Stadt",05,Nordrhein-Westfalen,8267,4192,4075,720,537,183,439,310,129,8.7,6.5,2.2,5.3,3.7,1.6
05766004,Augustdorf,05,Nordrhein-Westfalen,9828,5074,4754,883,586,297,482,341,141,9.0,6.0,3.0,4.9,3.5,1.4
05766008,"Bad Salzuflen, Stadt",05,Nordrhein-Westfalen,53341,25619,27722,5152,3558,1594,5371,3742,1629,9.7,6.7,3.0,10.1,7.0,3.1
05766012,"Barntrup, Stadt",05,Nordrhein-Westfalen,8846,4418,4428,746,548,198,646,470,176,8.4,6.2,2.2,7.3,5.3,2.0
05766016,"Blomberg, Stadt",05,Nordrhein-Westfalen,15370,7671,7699,1225,862,363,1198,853,345,8.0,5.6,2.4,7.8,5.5,2.2
05766020,"Detmold, Stadt",05,Nordrhein-Westfalen,74817,36141,38676,6715,4754,1961,6968,4915,2053,9.0,6.4,2.6,9.3,6.6,2.7
05766024,Dörentrup,05,Nordrhein-Westfalen,7970,4048,3922,654,447,207,516,375,141,8.2,5.6,2.6,6.5,4.7,1.8
05766028,Extertal,05,Nordrhein-Westfalen,11522,5795,5727,1098,789,309,772,557,215,9.5,6.8,2.7,6.7,4.8,1.9
05766032,"Horn-Bad Meinberg, Stadt",05,Nordrhein-Westfalen,17126,8324,8802,1621,1164,457,1380,1011,369,9.5,6.8,2.7,8.1,5.9,2.2
05766036,Kalletal,05,Nordrhein-Westfalen,13914,6902,7012,1268,905,363,856,601,255,9.1,6.5,2.6,6.2,4.3,1.8
05766040,"Lage, Stadt",05,Nordrhein-Westfalen,35120,17336,17784,3442,2423,1019,2493,1800,693,9.8,6.9,2.9,7.1,5.1,2.0
05766044,"Lemgo, Stadt",05,Nordrhein-Westfalen,41276,20457,20819,3821,2709,1112,3882,2744,1138,9.3,6.6,2.7,9.4,6.6,2.8
05766048,Leopoldshöhe,05,Nordrhein-Westfalen,16401,8148,8253,1549,1059,490,1286,868,418,9.4,6.5,3.0,7.8,5.3,2.5
05766052,"Lügde, Stadt der Osterräder",05,Nordrhein-Westfalen,9751,4851,4900,922,656,266,708,492,216,9.5,6.7,2.7,7.3,5.0,2.2
05766056,"Oerlinghausen, Stadt",05,Nordrhein-Westfalen,17616,8722,8894,1559,1034,525,1161,795,366,8.8,5.9,3.0,6.6,4.5,2.1
05766060,"Schieder-Schwalenberg, Stadt",05,Nordrhein-Westfalen,8708,4341,4367,706,517,189,445,323,122,8.1,5.9,2.2,5.1,3.7,1.4
05766064,Schlangen,05,Nordrhein-Westfalen,9144,4643,4501,871,615,256,485,332,153,9.5,6.7,2.8,5.3,3.6,1.7
05770004,"Bad Oeynhausen, Stadt",05,Nordrhein-Westfalen,48990,23905,25085,4247,2880,1367,5434,3588,1846,8.7,5.9,2.8,11.1,7.3,3.8
05770008,"Espelkamp, Stadt",05,Nordrhein-Westfalen,24921,12213,12708,2278,1486,792,2867,1910,957,9.1,6.0,3.2,11.5,7.7,3.8
05770012,Hille,05,Nordrhein-Westfalen,15916,7890,8026,1442,985,457,1032,712,320,9.1,6.2,2.9,6.5,4.5,2.0
05770016,Hüllhorst,05,Nordrhein-Westfalen,13271,6651,6620,1321,847,474,1116,741,375,10.0,6.4,3.6,8.4,5.6,2.8
05770020,"Lübbecke, Stadt",05,Nordrhein-Westfalen,25462,12270,13192,2384,1525,859,2821,1877,944,9.4,6.0,3.4,11.1,7.4,3.7
05770024,"Minden, Stadt",05,Nordrhein-Westfalen,81598,40066,41532,6902,4839,2063,7125,5003,2122,8.5,5.9,2.5,8.7,6.1,2.6
05770028,"Petershagen, Stadt",05,Nordrhein-Westfalen,25663,12945,12718,2281,1619,662,1688,1165,523,8.9,6.3,2.6,6.6,4.5,2.0
05770032,"Porta Westfalica, Stadt",05,Nordrhein-Westfalen,35430,17486,17944,3009,2019,990,2423,1664,759,8.5,5.7,2.8,6.8,4.7,2.1
05770036,"Preußisch Oldendorf, Stadt",05,Nordrhein-Westfalen,12647,6258,6389,1279,851,428,1107,752,355,10.1,6.7,3.4,8.8,5.9,2.8
05770040,"Rahden, Stadt",05,Nordrhein-Westfalen,15581,7844,7737,1541,974,567,1283,793,490,9.9,6.3,3.6,8.2,5.1,3.1
05770044,Stemwede,05,Nordrhein-Westfalen,13571,6960,6611,1451,950,501,1192,755,437,10.7,7.0,3.7,8.8,5.6,3.2
05774004,Altenbeken,05,Nordrhein-Westfalen,9294,4707,4587,896,628,268,551,387,164,9.6,6.8,2.9,5.9,4.2,1.8
05774008,"Bad Lippspringe, Stadt",05,Nordrhein-Westfalen,15572,7576,7996,1605,1054,551,1481,976,505,10.3,6.8,3.5,9.5,6.3,3.2
05774012,Borchen,05,Nordrhein-Westfalen,13447,6695,6752,1242,849,393,1058,720,338,9.2,6.3,2.9,7.9,5.4,2.5
05774016,"Büren, Stadt",05,Nordrhein-Westfalen,21772,11305,10467,2459,1644,815,2251,1483,768,11.3,7.6,3.7,10.3,6.8,3.5
05774020,"Delbrück, Stadt",05,Nordrhein-Westfalen,31964,16316,15648,4019,2762,1257,3626,2542,1084,12.6,8.6,3.9,11.3,8.0,3.4
05774024,"Hövelhof, Sennegemeinde",05,Nordrhein-Westfalen,16080,8166,7914,1961,1292,669,1948,1292,656,12.2,8.0,4.2,12.1,8.0,4.1
05774028,"Lichtenau, Stadt",05,Nordrhein-Westfalen,10589,5449,5140,1062,735,327,739,489,250,10.0,6.9,3.1,7.0,4.6,2.4
05774032,"Paderborn, Stadt",05,Nordrhein-Westfalen,148126,73680,74446,15528,11030,4498,18267,13077,5190,10.5,7.4,3.0,12.3,8.8,3.5
05774036,"Salzkotten, Stadt",05,Nordrhein-Westfalen,25186,12493,12693,2568,1820,748,2394,1718,676,10.2,7.2,3.0,9.5,6.8,2.7
05774040,"Bad Wünnenberg, Stadt",05,Nordrhein-Westfalen,12302,6162,6140,1437,1009,428,1303,899,404,11.7,8.2,3.5,10.6,7.3,3.3
05911000,"Bochum, Stadt",05,Nordrhein-Westfalen,364742,177427,187315,32256,24052,8204,33870,25088,8782,8.8,6.6,2.2,9.3,6.9,2.4
05913000,"Dortmund, Stadt",05,Nordrhein-Westfalen,586181,287846,298335,49951,37260,12691,53554,38838,14716,8.5,6.4,2.2,9.1,6.6,2.5
05914000,"Hagen, Stadt der FernUniversität",05,Nordrhein-Westfalen,189044,92207,96837,18085,12968,5117,18203,12840,5363,9.6,6.9,2.7,9.6,6.8,2.8
05915000,"Hamm, Stadt",05,Nordrhein-Westfalen,179397,88166,91231,16974,12657,4317,16532,12237,4295,9.5,7.1,2.4,9.2,6.8,2.4
05916000,"Herne, Stadt",05,Nordrhein-Westfalen,155851,75940,79911,12785,9709,3076,10244,7831,2413,8.2,6.2,2.0,6.6,5.0,1.5
05954004,"Breckerfeld, Hansestadt",05,Nordrhein-Westfalen,9004,4442,4562,738,512,226,572,388,184,8.2,5.7,2.5,6.4,4.3,2.0
05954008,"Ennepetal, Stadt der Kluterthöhle",05,Nordrhein-Westfalen,29926,14635,15291,2798,1869,929,2532,1660,872,9.3,6.2,3.1,8.5,5.5,2.9
05954012,"Gevelsberg, Stadt",05,Nordrhein-Westfalen,31315,15290,16025,3103,2147,956,2701,1900,801,9.9,6.9,3.1,8.6,6.1,2.6
05954016,"Hattingen, Stadt",05,Nordrhein-Westfalen,54834,26608,28226,5130,3661,1469,4414,3074,1340,9.4,6.7,2.7,8.0,5.6,2.4
05954020,"Herdecke, Stadt",05,Nordrhein-Westfalen,22818,10869,11949,2007,1390,617,2150,1546,604,8.8,6.1,2.7,9.4,6.8,2.6
05954024,"Schwelm, Stadt",05,Nordrhein-Westfalen,28330,13598,14732,2517,1748,769,2273,1490,783,8.9,6.2,2.7,8.0,5.3,2.8
05954028,"Sprockhövel, Stadt",05,Nordrhein-Westfalen,25205,12161,13044,2261,1553,708,2039,1457,582,9.0,6.2,2.8,8.1,5.8,2.3
05954032,"Wetter (Ruhr), Stadt",05,Nordrhein-Westfalen,27822,13712,14110,2274,1597,677,1889,1325,564,8.2,5.7,2.4,6.8,4.8,2.0
05954036,"Witten, Stadt",05,Nordrhein-Westfalen,96700,46997,49703,8751,6383,2368,8317,6009,2308,9.0,6.6,2.4,8.6,6.2,2.4
05958004,"Arnsberg, Stadt",05,Nordrhein-Westfalen,73784,36277,37507,8435,5727,2708,10518,7352,3166,11.4,7.8,3.7,14.3,10.0,4.3
05958008,Bestwig,05,Nordrhein-Westfalen,11170,5646,5524,1457,957,500,1395,990,405,13.0,8.6,4.5,12.5,8.9,3.6
05958012,"Brilon, Stadt",05,Nordrhein-Westfalen,26232,13070,13162,3209,2144,1065,3017,2009,1008,12.2,8.2,4.1,11.5,7.7,3.8
05958016,Eslohe (Sauerland),05,Nordrhein-Westfalen,8942,4554,4388,1115,800,315,1032,743,289,12.5,8.9,3.5,11.5,8.3,3.2
05958020,"Hallenberg, Stadt",05,Nordrhein-Westfalen,4541,2309,2232,536,396,140,382,269,113,11.8,8.7,3.1,8.4,5.9,2.5
05958024,"Marsberg, Stadt",05,Nordrhein-Westfalen,19968,10182,9786,1921,1334,587,1608,1162,446,9.6,6.7,2.9,8.1,5.8,2.2
05958028,"Medebach, Hansestadt",05,Nordrhein-Westfalen,7938,4008,3930,1071,735,336,1020,661,359,13.5,9.3,4.2,12.8,8.3,4.5
05958032,"Meschede, Kreis- und  Hochschulstadt",05,Nordrhein-Westfalen,30119,14916,15203,3478,2444,1034,3559,2480,1079,11.5,8.1,3.4,11.8,8.2,3.6
05958036,"Olsberg, Stadt",05,Nordrhein-Westfalen,14874,7389,7485,1820,1176,644,1806,1250,556,12.2,7.9,4.3,12.1,8.4,3.7
05958040,"Schmallenberg, Stadt",05,Nordrhein-Westfalen,25230,12826,12404,3382,2241,1141,3130,2066,1064,13.4,8.9,4.5,12.4,8.2,4.2
05958044,"Sundern (Sauerland), Stadt",05,Nordrhein-Westfalen,28166,14153,14013,3693,2488,1205,3269,2171,1098,13.1,8.8,4.3,11.6,7.7,3.9
05958048,"Winterberg, Stadt",05,Nordrhein-Westfalen,12798,6434,6364,1985,1256,729,2144,1356,788,15.5,9.8,5.7,16.8,10.6,6.2
05962004,"Altena, Stadt",05,Nordrhein-Westfalen,17375,8592,8783,1604,1109,495,1143,807,336,9.2,6.4,2.8,6.6,4.6,1.9
05962008,"Balve, Stadt",05,Nordrhein-Westfalen,11602,5745,5857,1444,1043,401,1205,877,328,12.4,9.0,3.5,10.4,7.6,2.8
05962012,"Halver, Stadt",05,Nordrhein-Westfalen,16117,7886,8231,1514,970,544,1570,1060,510,9.4,6.0,3.4,9.7,6.6,3.2
05962016,"Hemer, Stadt",05,Nordrhein-Westfalen,33535,16498,17037,3660,2584,1076,3261,2266,995,10.9,7.7,3.2,9.7,6.8,3.0
05962020,Herscheid,05,Nordrhein-Westfalen,7217,3577,3640,658,405,253,503,328,175,9.1,5.6,3.5,7.0,4.5,2.4
05962024,"Iserlohn, Stadt",05,Nordrhein-Westfalen,93537,45770,47767,9372,6617,2755,10098,7134,2964,10.0,7.1,2.9,10.8,7.6,3.2
05962028,"Kierspe, Stadt",05,Nordrhein-Westfalen,16300,8060,8240,1722,1193,529,1256,901,355,10.6,7.3,3.2,7.7,5.5,2.2
05962032,"Lüdenscheid, Stadt",05,Nordrhein-Westfalen,73354,35955,37399,6583,4113,2470,7831,5171,2660,9.0,5.6,3.4,10.7,7.0,3.6
05962036,"Meinerzhagen, Stadt",05,Nordrhein-Westfalen,20670,10359,10311,2078,1460,618,1998,1312,686,10.1,7.1,3.0,9.7,6.3,3.3
05962040,"Menden (Sauerland), Stadt",05,Nordrhein-Westfalen,53485,26238,27247,5580,3977,1603,4887,3553,1334,10.4,7.4,3.0,9.1,6.6,2.5
05962044,Nachrodt-Wiblingwerde,05,Nordrhein-Westfalen,6644,3332,3312,586,422,164,300,220,80,8.8,6.4,2.5,4.5,3.3,1.2
05962048,"Neuenrade, Stadt",05,Nordrhein-Westfalen,12024,5991,6033,1235,840,395,1111,787,324,10.3,7.0,3.3,9.2,6.5,2.7
05962052,"Plettenberg, Stadt",05,Nordrhein-Westfalen,25781,12851,12930,2603,1785,818,2432,1621,811,10.1,6.9,3.2,9.4,6.3,3.1
05962056,Schalksmühle,05,Nordrhein-Westfalen,10528,5194,5334,1011,638,373,832,527,305,9.6,6.1,3.5,7.9,5.0,2.9
05962060,"Werdohl, Stadt",05,Nordrhein-Westfalen,18002,8939,9063,1656,1191,465,1333,955,378,9.2,6.6,2.6,7.4,5.3,2.1
05966004,"Attendorn, Hansestadt",05,Nordrhein-Westfalen,24676,12499,12177,2722,1843,879,2585,1746,839,11.0,7.5,3.6,10.5,7.1,3.4
05966008,"Drolshagen, Stadt",05,Nordrhein-Westfalen,11874,6003,5871,1429,960,469,1058,685,373,12.0,8.1,3.9,8.9,5.8,3.1
05966012,Finnentrop,05,Nordrhein-Westfalen,17258,8849,8409,2193,1480,713,1573,1082,491,12.7,8.6,4.1,9.1,6.3,2.8
05966016,Kirchhundem,05,Nordrhein-Westfalen,11854,6016,5838,1522,1007,515,1342,876,466,12.8,8.5,4.3,11.3,7.4,3.9
05966020,"Lennestadt, Stadt",05,Nordrhein-Westfalen,26073,13154,12919,3390,2338,1052,3535,2431,1104,13.0,9.0,4.0,13.6,9.3,4.2
05966024,"Olpe, Stadt",05,Nordrhein-Westfalen,24757,12107,12650,2913,1875,1038,3609,2436,1173,11.8,7.6,4.2,14.6,9.8,4.7
05966028,Wenden,05,Nordrhein-Westfalen,19873,9996,9877,2494,1677,817,2033,1360,673,12.5,8.4,4.1,10.2,6.8,3.4
05970004,"Bad Berleburg, Stadt",05,Nordrhein-Westfalen,19774,10017,9757,2099,1362,737,2003,1315,688,10.6,6.9,3.7,10.1,6.7,3.5
05970008,Burbach,05,Nordrhein-Westfalen,14969,7758,7211,1771,1173,598,1536,1008,528,11.8,7.8,4.0,10.3,6.7,3.5
05970012,Erndtebrück,05,Nordrhein-Westfalen,7206,3671,3535,843,575,268,687,474,213,11.7,8.0,3.7,9.5,6.6,3.0
05970016,"Freudenberg, Stadt",05,Nordrhein-Westfalen,17929,8935,8994,1993,1398,595,1640,1134,506,11.1,7.8,3.3,9.1,6.3,2.8
05970020,"Hilchenbach, Stadt",05,Nordrhein-Westfalen,15169,7537,7632,1556,1112,444,1037,708,329,10.3,7.3,2.9,6.8,4.7,2.2
05970024,"Kreuztal, Stadt",05,Nordrhein-Westfalen,31500,15642,15858,3263,2348,915,2771,1994,777,10.4,7.5,2.9,8.8,6.3,2.5
05970028,"Bad Laasphe, Stadt",05,Nordrhein-Westfalen,14276,7261,7015,1523,1080,443,1127,808,319,10.7,7.6,3.1,7.9,5.7,2.2
05970032,"Netphen, Stadt",05,Nordrhein-Westfalen,23393,11720,11673,2707,1875,832,2146,1565,581,11.6,8.0,3.6,9.2,6.7,2.5
05970036,Neunkirchen,05,Nordrhein-Westfalen,13717,6954,6763,1609,1130,479,1291,921,370,11.7,8.2,3.5,9.4,6.7,2.7
05970040,"Siegen, Universitätsstadt",05,Nordrhein-Westfalen,102355,49925,52430,12104,8705,3399,15626,11006,4620,11.8,8.5,3.3,15.3,10.8,4.5
05970044,Wilnsdorf,05,Nordrhein-Westfalen,20512,10206,10306,2522,1750,772,2117,1423,694,12.3,8.5,3.8,10.3,6.9,3.4
05974004,Anröchte,05,Nordrhein-Westfalen,10557,5361,5196,1357,911,446,1346,930,416,12.9,8.6,4.2,12.7,8.8,3.9
05974008,Bad Sassendorf,05,Nordrhein-Westfalen,11931,5735,6196,1147,819,328,1118,784,334,9.6,6.9,2.7,9.4,6.6,2.8
05974012,Ense,05,Nordrhein-Westfalen,12442,6269,6173,1494,993,501,1081,692,389,12.0,8.0,4.0,8.7,5.6,3.1
05974016,"Erwitte, Stadt",05,Nordrhein-Westfalen,16128,7968,8160,1771,1200,571,1373,988,385,11.0,7.4,3.5,8.5,6.1,2.4
05974020,"Geseke, Stadt",05,Nordrhein-Westfalen,21070,10487,10583,2405,1679,726,2096,1475,621,11.4,8.0,3.4,9.9,7.0,2.9
05974024,Lippetal,05,Nordrhein-Westfalen,12027,6044,5983,1349,931,418,1085,751,334,11.2,7.7,3.5,9.0,6.2,2.8
05974028,"Lippstadt, Stadt",05,Nordrhein-Westfalen,67233,33073,34160,7278,4954,2324,7481,5140,2341,10.8,7.4,3.5,11.1,7.6,3.5
05974032,Möhnesee,05,Nordrhein-Westfalen,11608,5987,5621,1178,844,334,1673,1210,463,10.1,7.3,2.9,14.4,10.4,4.0
05974036,"Rüthen, Stadt",05,Nordrhein-Westfalen,11095,5790,5305,1211,830,381,833,558,275,10.9,7.5,3.4,7.5,5.0,2.5
05974040,"Soest, Stadt",05,Nordrhein-Westfalen,47974,23245,24729,5184,3684,1500,5632,4072,1560,10.8,7.7,3.1,11.7,8.5,3.3
05974044,"Warstein, Stadt",05,Nordrhein-Westfalen,25407,12721,12686,2518,1781,737,2150,1495,655,9.9,7.0,2.9,8.5,5.9,2.6
05974048,Welver,05,Nordrhein-Westfalen,12140,6071,6069,1164,804,360,638,428,210,9.6,6.6,3.0,5.3,3.5,1.7
05974052,"Werl, Stadt",05,Nordrhein-Westfalen,30638,15681,14957,3397,2417,980,2977,2134,843,11.1,7.9,3.2,9.7,7.0,2.8
05974056,Wickede (Ruhr),05,Nordrhein-Westfalen,12745,6629,6116,1386,937,449,1205,801,404,10.9,7.4,3.5,9.5,6.3,3.2
05978004,"Bergkamen, Stadt",05,Nordrhein-Westfalen,47803,23562,24241,4924,3850,1074,3283,2547,736,10.3,8.1,2.2,6.9,5.3,1.5
05978008,Bönen,05,Nordrhein-Westfalen,18059,8790,9269,1621,1234,387,1245,858,387,9.0,6.8,2.1,6.9,4.8,2.1
05978012,"Fröndenberg/Ruhr, Stadt",05,Nordrhein-Westfalen,20961,10293,10668,2037,1471,566,1607,1147,460,9.7,7.0,2.7,7.7,5.5,2.2
05978016,Holzwickede,05,Nordrhein-Westfalen,17085,8310,8775,1564,1130,434,2144,1710,434,9.2,6.6,2.5,12.5,10.0,2.5
05978020,"Kamen, Stadt",05,Nordrhein-Westfalen,43868,21485,22383,3926,2945,981,3888,2920,968,8.9,6.7,2.2,8.9,6.7,2.2
05978024,"Lünen, Stadt",05,Nordrhein-Westfalen,85867,41810,44057,7900,6024,1876,7386,5590,1796,9.2,7.0,2.2,8.6,6.5,2.1
05978028,"Schwerte, Hansestadt an der Ruhr",05,Nordrhein-Westfalen,46723,22767,23956,4145,2983,1162,3726,2715,1011,8.9,6.4,2.5,8.0,5.8,2.2
05978032,"Selm, Stadt",05,Nordrhein-Westfalen,26603,13272,13331,2607,1930,677,2325,1733,592,9.8,7.3,2.5,8.7,6.5,2.2
05978036,"Unna, Stadt",05,Nordrhein-Westfalen,59111,28581,30530,5651,4059,1592,6138,4462,1676,9.6,6.9,2.7,10.4,7.5,2.8
05978040,"Werne, Stadt",05,Nordrhein-Westfalen,29955,14568,15387,2826,2076,750,2823,2081,742,9.4,6.9,2.5,9.4,6.9,2.5
