rs,name,bundesland,bundesland_id,bevoelkerung_total,bevoelkerung_maennlich,bevoelkerung_weiblich,minijobber_total,minijobber_maennlich,minijobber_weiblich,minijobber_total_prozent,minijobber_maennlich_prozent,minijobber_weiblich_prozent
05111,Düsseldorf,Nordrhein-Westfalen,05,612178,295896,316282,75109,30847,44262,12.3,10.4,14.0
05112,Duisburg,Nordrhein-Westfalen,05,491231,241417,249814,37129,15084,22045,7.6,6.2,8.8
05113,Essen,Nordrhein-Westfalen,05,582624,282565,300059,60551,24471,36080,10.4,8.7,12.0
05114,Krefeld,Nordrhein-Westfalen,05,225144,109487,115657,20927,8111,12816,9.3,7.4,11.1
05116,Mönchengladbach,Nordrhein-Westfalen,05,259996,127512,132484,28281,10704,17577,10.9,8.4,13.3
05117,Mülheim an der Ruhr,Nordrhein-Westfalen,05,169278,81461,87817,15644,6324,9320,9.2,7.8,10.6
05119,Oberhausen,Nordrhein-Westfalen,05,210934,103284,107650,20304,7447,12857,9.6,7.2,11.9
05120,Remscheid,Nordrhein-Westfalen,05,109499,53725,55774,11788,4487,7301,10.8,8.4,13.1
05122,Solingen,Nordrhein-Westfalen,05,158726,76948,81778,13985,5749,8236,8.8,7.5,10.1
05124,Wuppertal,Nordrhein-Westfalen,05,350046,170822,179224,33212,13483,19729,9.5,7.9,11.0
05154,Kleve,Nordrhein-Westfalen,05,310337,154988,155349,34563,13043,21520,11.1,8.4,13.9
05158,Mettmann,Nordrhein-Westfalen,05,483279,233448,249831,46568,18840,27728,9.6,8.1,11.1
05162,Rhein-Kreis Neuss,Nordrhein-Westfalen,05,450026,219650,230376,37887,14489,23398,8.4,6.6,10.2
05166,Viersen,Nordrhein-Westfalen,05,297661,145470,152191,29388,11364,18024,9.9,7.8,11.8
05170,Wesel,Nordrhein-Westfalen,05,462664,226396,236268,48031,17955,30076,10.4,7.9,12.7
05314,Bonn,Nordrhein-Westfalen,05,318809,151954,166855,38938,15901,23037,12.2,10.5,13.8
05315,Köln,Nordrhein-Westfalen,05,1060582,516976,543606,122235,51410,70825,11.5,9.9,13.0
05316,Leverkusen,Nordrhein-Westfalen,05,163487,79590,83897,12746,4723,8023,7.8,5.9,9.6
05334,Städteregion Aachen,Nordrhein-Westfalen,05,553922,279260,274662,66107,29607,36500,11.9,10.6,13.3
05358,Düren,Nordrhein-Westfalen,05,262828,130522,132306,28648,10514,18134,10.9,8.1,13.7
05362,Rhein-Erft-Kreis,Nordrhein-Westfalen,05,466657,228450,238207,43562,17344,26218,9.3,7.6,11.0
05366,Euskirchen,Nordrhein-Westfalen,05,191165,94759,96406,17865,6620,11245,9.3,7.0,11.7
05370,Heinsberg,Nordrhein-Westfalen,05,252527,124956,127571,26605,9714,16891,10.5,7.8,13.2
05374,Oberbergischer Kreis,Nordrhein-Westfalen,05,273452,134670,138782,28978,11120,17858,10.6,8.3,12.9
05378,Rheinisch-Bergischer Kreis,Nordrhein-Westfalen,05,282729,137438,145291,26967,10517,16450,9.5,7.7,11.3
05382,Rhein-Sieg-Kreis,Nordrhein-Westfalen,05,596213,292555,303658,60490,23892,36598,10.1,8.2,12.1
05512,Bottrop,Nordrhein-Westfalen,05,117143,57004,60139,10516,4041,6475,9.0,7.1,10.8
05513,Gelsenkirchen,Nordrhein-Westfalen,05,260368,129267,131101,24122,10160,13962,9.3,7.9,10.6
05515,Münster,Nordrhein-Westfalen,05,310039,148447,161592,40351,16494,23857,13.0,11.1,14.8
05554,Borken,Nordrhein-Westfalen,05,369666,184973,184693,50493,19453,31040,13.7,10.5,16.8
05558,Coesfeld,Nordrhein-Westfalen,05,218401,107953,110448,22962,8481,14481,10.5,7.9,13.1
05562,Recklinghausen,Nordrhein-Westfalen,05,617807,301893,315914,52300,19907,32393,8.5,6.6,10.3
05566,Steinfurt,Nordrhein-Westfalen,05,443374,220782,222592,52402,20884,31518,11.8,9.5,14.2
05570,Warendorf,Nordrhein-Westfalen,05,277431,137265,140166,30115,11588,18527,10.9,8.4,13.2
05711,Bielefeld,Nordrhein-Westfalen,05,333090,161148,171942,37728,15559,22169,11.3,9.7,12.9
05754,Gütersloh,Nordrhein-Westfalen,05,360642,180222,180420,41734,16036,25698,11.6,8.9,14.2
05758,Herford,Nordrhein-Westfalen,05,252122,123935,128187,23056,9271,13785,9.1,7.5,10.8
05762,Höxter,Nordrhein-Westfalen,05,144010,72006,72004,13374,4492,8882,9.3,6.2,12.3
05766,Lippe,Nordrhein-Westfalen,05,350750,172490,178260,29523,11447,18076,8.4,6.6,10.1
05770,Minden-Lübbecke,Nordrhein-Westfalen,05,313050,154488,158562,29852,11160,18692,9.5,7.2,11.8
05774,Paderborn,Nordrhein-Westfalen,05,304332,152549,151783,35559,14024,21535,11.7,9.2,14.2
05911,Bochum,Nordrhein-Westfalen,05,364742,177427,187315,33760,13635,20125,9.3,7.7,10.7
05913,Dortmund,Nordrhein-Westfalen,05,586181,287846,298335,55379,22396,32983,9.4,7.8,11.1
05914,Hagen,Nordrhein-Westfalen,05,189044,92207,96837,18500,7488,11012,9.8,8.1,11.4
05915,Hamm,Nordrhein-Westfalen,05,179397,88166,91231,16995,6965,10030,9.5,7.9,11.0
05916,Herne,Nordrhein-Westfalen,05,155851,75940,79911,10423,4214,6209,6.7,5.5,7.8
05954,Ennepe-Ruhr-Kreis,Nordrhein-Westfalen,05,325954,158312,167642,27065,10127,16938,8.3,6.4,10.1
05958,Hochsauerlandkreis,Nordrhein-Westfalen,05,263762,131764,131998,33384,12366,21018,12.7,9.4,15.9
05962,Märkischer Kreis,Nordrhein-Westfalen,05,416171,204987,211184,42047,15967,26080,10.1,7.8,12.3
05966,Olpe,Nordrhein-Westfalen,05,136365,68624,67741,16355,6057,10298,12.0,8.8,15.2
05970,Siegen-Wittgenstein,Nordrhein-Westfalen,05,280800,139626,141174,32266,12260,20006,11.5,8.8,14.2
05974,Soest,Nordrhein-Westfalen,05,302995,151061,151934,31616,12057,19559,10.4,8.0,12.9
05978,Unna,Nordrhein-Westfalen,05,396035,193438,202597,34776,13718,21058,8.8,7.1,10.4
